BC	flags
GCATCGTACACCGGAT_GATCCACAGCCTGTAT_ATCAGTAAACTTTCAA_GTGGTAATCGCTCTGA_GTACCTCTGACCCAAT	P
GCATCGTACACCGGAT_GATCCACAGCCTGTAT_ATCAGTAAACTTTCAA_GTGGTAATCGCTCTGA_CAGTAACGATTTGGCA	P
GCATCGTACACCGGAT_GATCCACAGCCTGTAT_ATCAGTAAACTTTCAA_GTGGTAATCGCTCTGA_AAACCAGGTGACGTTG	P
TTTGGCAACCTGGGTG_TATTGCAGTTATGCAG_CAACCACCCGCATTCA_TGAGGGAACCCCTTGA_ACGGTTATGTAACCGG	A;R(C)
ATAATGAGTGCACCTT_CAAGCATACTTATATG_CTGACAGCCGAGCCCT_TTCCTGAGAAGATTGC_GACCCTCAACACATCG	C
TACAGGGGATGAAGCT_GTTGATTGGACGGATG_ATTACATATGCACGCC_ATTTCGGGGACGCGCC_AGATAAACTGATTGCT	C
TACAGGGGATGAAGCT_GTTGATTGGACGGATG_ATTACATATGCACGCC_ATTTCGGGGACGCGCC_CGACCCCGAGAGTGCG	P
TACAGGGGATGAAGCT_GTTGATTGGACGGATG_ATTACATATGCACGCC_ATTTCGGGGACGCGCC_TCGGCTACCCAGTCCC	P
TACAGGGGATGAAGCT_GTTGATTGGACGGATG_ATTACATATGCACGCC_ATTTCGGGGACGCGCC_AGAGTCAGCTAGTATT	P
TACAGGGGATGAAGCT_GTTGATTGGACGGATG_ATTACATATGCACGCC_ATTTCGGGGACGCGCC_TGGTAACCGGGTCCTT	C
TACAGGGGATGAAGCT_GTTGATTGGACGGATG_ATTACATATGCACGCC_ATTTCGGGGACGCGCC_AGCGGAAATTGCGTCT	P
TACAGGGGATGAAGCT_GTTGATTGGACGGATG_ATTACATATGCACGCC_ATTTCGGGGACGCGCC_TCAGGGGAGGTTCGTC	C
TACAGGGGATGAAGCT_GTTGATTGGACGGATG_ATTACATATGCACGCC_ATTTCGGGGACGCGCC_CTAGCTATGTTCACCC	C
TTTGGCAACCTGGGTG_TATTGCAGTTATGCAG_TCCGATGGCTTCGAGT_TAGATGGGTTCTGAGC_CGGCCGATCTCGACTT	B;R(P)
CCTGGAGCAGTCTAAT_CTGTGTCCAGCCTCGT_CCACTAATCGCCACAT_CGGTTAGCCCCGCGTG_CTGAGAACTCGGATAA	P
ATCGTTGAATACACGC_CTTGCGCTCGAATGAT_AATTAGGGTTAGCCCC_TTAACTGCGGCAGCTT_AGGCCCGCGCGCCTAT	P
TCTAAGCGTATTGGTC_ATCCAGCGCTTGGACG_AGATGAACCGGCCCAT_TCGGCTAAAGGTTGCG_GCAGCATCCACGAAGA	P
TCTAAGCGTATTGGTC_ATCCAGCGCTTGGACG_AGATGAACCGGCCCAT_TCGGCTAAAGGTTGCG_TCGTACCGTGGCATTG	P
TCTAAGCGTATTGGTC_ATCCAGCGCTTGGACG_AGATGAACCGGCCCAT_TCGGCTAAAGGTTGCG_CAGAACCTTTGAGGAT	P
GCATCGTACACCGGAT_GATCCACAGCCTGTAT_ATCAGTAAACTTTCAA_GTGGTAATCGCTCTGA_AACTGTCCCGATCCAG	P
GCATCGTACACCGGAT_GATCCACAGCCTGTAT_ATCAGTAAACTTTCAA_GTGGTAATCGCTCTGA_GCCAAATGGTAAGGCA	P
GCATCGTACACCGGAT_GATCCACAGCCTGTAT_ATCAGTAAACTTTCAA_GTGGTAATCGCTCTGA_CACAGCATTTTGGGAG	P
GCATCGTACACCGGAT_GATCCACAGCCTGTAT_ATCAGTAAACTTTCAA_GTGGTAATCGCTCTGA_CATAAAGATTGTGAAG	P
GCATCGTACACCGGAT_GATCCACAGCCTGTAT_ATCAGTAAACTTTCAA_GTGGTAATCGCTCTGA_AGGAGACGTGAGATGT	P
GCATCGTACACCGGAT_GATCCACAGCCTGTAT_ATCAGTAAACTTTCAA_GTGGTAATCGCTCTGA_ACAGCGCGATCGCGTC	P
GCATCGTACACCGGAT_GATCCACAGCCTGTAT_ATCAGTAAACTTTCAA_GTGGTAATCGCTCTGA_GAAGACGGACACCTAG	P
GCATCGTACACCGGAT_GATCCACAGCCTGTAT_ATCAGTAAACTTTCAA_GTGGTAATCGCTCTGA_TACAGGTCTGCGCATC	P
GCATCGTACACCGGAT_GATCCACAGCCTGTAT_ATCAGTAAACTTTCAA_GTGGTAATCGCTCTGA_TGCCGCTTCCCCGCAC	P
GCATCGTACACCGGAT_GATCCACAGCCTGTAT_ATCAGTAAACTTTCAA_GTGGTAATCGCTCTGA_CATCTCCCTCCGACTC	P
GCATCGTACACCGGAT_GATCCACAGCCTGTAT_ATCAGTAAACTTTCAA_GTGGTAATCGCTCTGA_TACGCGCAATTATCGA	P
TAGTGACTTAGACCTG_CTTATCAACGGTGCTA_CAACCTGTAATTCTGC_AGGACACGCAAGAAAT_AGGGAAAACGGGTGTG	P
TAGTGACTTAGACCTG_CTTATCAACGGTGCTA_AAGGGTCCCCGAATTA_TCGACCTCGCTCTGAT_AAAAGACAAGAACTTG	P
ATAATGAGTGCACCTT_CAAGCATACTTATATG_CTGACAGCCGAGCCCT_GTAACGATAAAGAGCA_TTGAGACCGTTCAGCG	P
ATAATGAGTGCACCTT_CAAGCATACTTATATG_CTGACAGCCGAGCCCT_GTAACGATAAAGAGCA_TGAGGGCGCACTGTCT	P
ATAATGAGTGCACCTT_CAAGCATACTTATATG_CTGACAGCCGAGCCCT_GTAACGATAAAGAGCA_CTATTACGGCCACCCA	P
TAGTGACTTAGACCTG_CTTATCAACGGTGCTA_TGCCTCGAAGGCCTAT_ATAGGGGTCGGACAAA_AGTACCACAGCGCAAG	P
TCTAAGCGTATTGGTC_ATCCAGCGCTTGGACG_AGATGAACCGGCCCAT_TACAAGCAGTAGGACA_CATAGCACCACTGATA	P
TCTAAGCGTATTGGTC_ATCCAGCGCTTGGACG_AGATGAACCGGCCCAT_TACAAGCAGTAGGACA_AGTCGTCGTAGTCCGA	P
TCTAAGCGTATTGGTC_ATCCAGCGCTTGGACG_AGATGAACCGGCCCAT_TACAAGCAGTAGGACA_GCCAGCTTCCAACGCG	P
TCTAAGCGTATTGGTC_ATCCAGCGCTTGGACG_AGATGAACCGGCCCAT_TACAAGCAGTAGGACA_TTCAGTTACGGCAGAT	P
TCTAAGCGTATTGGTC_ATCCAGCGCTTGGACG_AGATGAACCGGCCCAT_GGTCTCCAAAAGCGGT_TGCAAGATCCTGGTTA	P
TCTAAGCGTATTGGTC_ATCCAGCGCTTGGACG_AGATGAACCGGCCCAT_GGTCTCCAAAAGCGGT_TTACTGGGACGCAGCG	P
TCTAAGCGTATTGGTC_ATCCAGCGCTTGGACG_AGATGAACCGGCCCAT_GGTCTCCAAAAGCGGT_GTTCGCTAGTTGTACC	P
TCTAAGCGTATTGGTC_ATCCAGCGCTTGGACG_AGATGAACCGGCCCAT_GGTCTCCAAAAGCGGT_TGGCGTCGGCGCAGCC	C
TAGTGACTTAGACCTG_CTTATCAACGGTGCTA_TGCCTCGAAGGCCTAT_CAGGACTACGGTCTAC_GCGGGGTCAACGATTT	P
TCTAAGCGTATTGGTC_ATCCAGCGCTTGGACG_AGATGAACCGGCCCAT_AGTGCATACTTAGTAG_CATGAGCGTCGGACCG	P
TCTAAGCGTATTGGTC_ATCCAGCGCTTGGACG_AGATGAACCGGCCCAT_AGTGCATACTTAGTAG_TATAGCGGAACCGTGG	P
TCTAAGCGTATTGGTC_ATCCAGCGCTTGGACG_AGATGAACCGGCCCAT_AGTGCATACTTAGTAG_AACTCATCTCCAAGCG	P
TAGTGACTTAGACCTG_CTTATCAACGGTGCTA_ACCGTCCGTGCGCTTT_CAGCAAATATAGAGAA_ACCACCGTACCACTGT	P
CCTGGAGCAGTCTAAT_CTGTGTCCAGCCTCGT_CCACTAATCGCCACAT_CCTTGTGGCCCTCACA_TATTTAAATCAACCAG	P
ATAATGAGTGCACCTT_CAAGCATACTTATATG_TCATTCAAGGTTCCAA_GCGGTAACGGTGGCTG_CTTGTCCTATGCGGAT	P
TCTAAGCGTATTGGTC_ATCCAGCGCTTGGACG_TCTCCGCTACGCGAGT_ATTGCCCGACTTTAGC_TCGTGGATGGAGAGTC	P
TCTAAGCGTATTGGTC_ATCCAGCGCTTGGACG_TCTCCGCTACGCGAGT_ATTGCCCGACTTTAGC_TTGAATTCGCATTGGA	A;R(P)
TCTAAGCGTATTGGTC_ATCCAGCGCTTGGACG_TCTCCGCTACGCGAGT_ATTGCCCGACTTTAGC_AGGACCTTGTGTCTGT	P
TCTAAGCGTATTGGTC_ATCCAGCGCTTGGACG_TCTCCGCTACGCGAGT_ATTGCCCGACTTTAGC_ATTGCACGAAGGGGCA	P
TCTAAGCGTATTGGTC_ATCCAGCGCTTGGACG_TCTCCGCTACGCGAGT_ATTGCCCGACTTTAGC_AAGCCGAGGCTATTTC	C
TCTAAGCGTATTGGTC_ATCCAGCGCTTGGACG_TCTCCGCTACGCGAGT_ATTGCCCGACTTTAGC_AAATGGACTTACGATG	P
TCTAAGCGTATTGGTC_ATCCAGCGCTTGGACG_TCTCCGCTACGCGAGT_ATTGCCCGACTTTAGC_GACCCATGCCGTGTTT	P
ATAATGAGTGCACCTT_CAAGCATACTTATATG_ACGTCTTAAGCCGCAT_AAGAGGCAAGACTGTA_TCGGATCTTGTGACAT	P
ATAATGAGTGCACCTT_CAAGCATACTTATATG_ACGTCTTAAGCCGCAT_AAGAGGCAAGACTGTA_GTTGGTTGACACACAT	P
ATAATGAGTGCACCTT_CAAGCATACTTATATG_ACGTCTTAAGCCGCAT_AAGAGGCAAGACTGTA_CTCCAAGCAAGAAAGC	P
TAGTGACTTAGACCTG_CTTATCAACGGTGCTA_CAACCTGTAATTCTGC_CTAGGCGACGGTGACT_CCATCTAATACCTAGA	P
TAGTGACTTAGACCTG_CTTATCAACGGTGCTA_AAGATTCAGCGTATAA_CCAACGCAAAGATAAC_CTTACCCAGTTTACAC	P
TAGTGACTTAGACCTG_CTTATCAACGGTGCTA_CAACCTGTAATTCTGC_GGCAGGTAGACCTTCA_GAGAAGAATGGAATGA	C
TCTAAGCGTATTGGTC_ATCCAGCGCTTGGACG_AGATGAACCGGCCCAT_TACAGGAGGACAGATC_TTTGCCGGCACCGACG	P
TAGTGACTTAGACCTG_CTTATCAACGGTGCTA_TGCCTCGAAGGCCTAT_GAGGGGGAGTGTCTTC_GCCAAACAATACGTTA	P
TAGTGACTTAGACCTG_CTTATCAACGGTGCTA_ACCGTCCGTGCGCTTT_GTTACAGATGAATGGG_CCCTGTGTTTTCGCGG	P
TCTAAGCGTATTGGTC_ATCCAGCGCTTGGACG_AGATGAACCGGCCCAT_TCTGGATGGGTACTTT_ATCCACAAGAGGAATG	P
TCTAAGCGTATTGGTC_ATCCAGCGCTTGGACG_AGATGAACCGGCCCAT_TCTGGATGGGTACTTT_TTGGAGGAGTATCGTT	P
TCTAAGCGTATTGGTC_ATCCAGCGCTTGGACG_AGATGAACCGGCCCAT_TCTGGATGGGTACTTT_AGGCCAGATATTACGT	P
TACAGGGGATGAAGCT_GTTGATTGGACGGATG_ATTACATATGCACGCC_ATTTCGGGGACGCGCC_CTGTTCGCATCTTTCC	P
TACAGGGGATGAAGCT_GTTGATTGGACGGATG_ATTACATATGCACGCC_ATTTCGGGGACGCGCC_ACGTAATGGATCATCT	P
TACAGGGGATGAAGCT_GTTGATTGGACGGATG_ATTACATATGCACGCC_ATTTCGGGGACGCGCC_TATAGACAGGTGCGTA	P
TACAGGGGATGAAGCT_GTTGATTGGACGGATG_ATTACATATGCACGCC_ATTTCGGGGACGCGCC_TTATAGCGGAGCGGGA	P
TACAGGGGATGAAGCT_GTTGATTGGACGGATG_ATTACATATGCACGCC_ATTTCGGGGACGCGCC_TCTTTGGTAATCGAAA	P
TACAGGGGATGAAGCT_GTTGATTGGACGGATG_ATTACATATGCACGCC_ATTTCGGGGACGCGCC_TAGTCACCGCAGACCA	P
TACAGGGGATGAAGCT_GTTGATTGGACGGATG_ATTACATATGCACGCC_ATTTCGGGGACGCGCC_CCAAGAGTCCTGAGCC	P
TACAGGGGATGAAGCT_GTTGATTGGACGGATG_ATTACATATGCACGCC_ATTTCGGGGACGCGCC_TAGAGACGCCCCCGAC	P
TACAGGGGATGAAGCT_GTTGATTGGACGGATG_ATTACATATGCACGCC_ATTTCGGGGACGCGCC_TCTGCTAACGACGTCG	P
TACAGGGGATGAAGCT_GTTGATTGGACGGATG_ATTACATATGCACGCC_ATTTCGGGGACGCGCC_TAGCGACGGTAATTCC	P
TACAGGGGATGAAGCT_GTTGATTGGACGGATG_ATTACATATGCACGCC_ATTTCGGGGACGCGCC_GAGCCAACTACGTACA	P
TACAGGGGATGAAGCT_GTTGATTGGACGGATG_ATTACATATGCACGCC_ATTTCGGGGACGCGCC_CTTTTAGCGGCGGAGC	P
TACAGGGGATGAAGCT_GTTGATTGGACGGATG_ATTACATATGCACGCC_ATTTCGGGGACGCGCC_CCTCGGTTTGGGACGT	P
TACAGGGGATGAAGCT_GTTGATTGGACGGATG_ATTACATATGCACGCC_ATTTCGGGGACGCGCC_ACCTCTCGCATCCAAC	P
TACAGGGGATGAAGCT_GTTGATTGGACGGATG_ATTACATATGCACGCC_ATTTCGGGGACGCGCC_GAGGTACGTAGGGTCT	P
TACAGGGGATGAAGCT_GTTGATTGGACGGATG_ATTACATATGCACGCC_ATTTCGGGGACGCGCC_TCCGCATATAGGTTAC	P
TACAGGGGATGAAGCT_GTTGATTGGACGGATG_ATTACATATGCACGCC_ATTTCGGGGACGCGCC_TTCAAGCCTTACGGAC	P
TACAGGGGATGAAGCT_GTTGATTGGACGGATG_ATTACATATGCACGCC_ATTTCGGGGACGCGCC_TTCCGTAGCCACACAC	P
TACAGGGGATGAAGCT_GTTGATTGGACGGATG_ATTACATATGCACGCC_ATTTCGGGGACGCGCC_CCAAGCAAGGTGATAC	P
TACAGGGGATGAAGCT_GTTGATTGGACGGATG_ATTACATATGCACGCC_ATTTCGGGGACGCGCC_AACTGGCCAAATGACC	P
TACAGGGGATGAAGCT_GTTGATTGGACGGATG_ATTACATATGCACGCC_ATTTCGGGGACGCGCC_TATCGGCAGACAAGAA	P
TACAGGGGATGAAGCT_GTTGATTGGACGGATG_ATTACATATGCACGCC_ATTTCGGGGACGCGCC_GGTGGACTGAACATAC	P
TACAGGGGATGAAGCT_GTTGATTGGACGGATG_ATTACATATGCACGCC_ATTTCGGGGACGCGCC_TGGTATAGCTATGCAG	P
TACAGGGGATGAAGCT_GTTGATTGGACGGATG_ATTACATATGCACGCC_ATTTCGGGGACGCGCC_CTGGGTTCACCTGTTG	P
TACAGGGGATGAAGCT_GTTGATTGGACGGATG_ATTACATATGCACGCC_ATTTCGGGGACGCGCC_GGTAATCCGCTGATTA	P
TACAGGGGATGAAGCT_GTTGATTGGACGGATG_ATTACATATGCACGCC_ATTTCGGGGACGCGCC_CAGGATACTGGAGCTC	P
TACAGGGGATGAAGCT_GTTGATTGGACGGATG_ATTACATATGCACGCC_ATTTCGGGGACGCGCC_ACGTATGTCCAGTACG	P
TACAGGGGATGAAGCT_GTTGATTGGACGGATG_ATTACATATGCACGCC_ATTTCGGGGACGCGCC_CATATGACTAGACAGG	P
TACAGGGGATGAAGCT_GTTGATTGGACGGATG_ATTACATATGCACGCC_ATTTCGGGGACGCGCC_TAAGTACCTACACGTA	P
TAGTGACTTAGACCTG_CTTATCAACGGTGCTA_TGCCTCGAAGGCCTAT_CTGAAGCAGGTTCTTA_CCCCTAATAAGGAAGG	P
CCTGGAGCAGTCTAAT_CTGTGTCCAGCCTCGT_CTCCGCCGTCCGCATT_ACGCTCGATATCATGC_CGGGAAGTTCACAGTC	P
TAGTGACTTAGACCTG_CTTATCAACGGTGCTA_TGCCTCGAAGGCCTAT_CAGCAACCGCGTTACA_CCTGCCCGTGCGAGAA	A
TCTAAGCGTATTGGTC_ATCCAGCGCTTGGACG_AGATGAACCGGCCCAT_AAATTGTTAGGGTGTC_CTCACTCAATTCAAAA	P
TCTAAGCGTATTGGTC_ATCCAGCGCTTGGACG_AGATGAACCGGCCCAT_AAATTGTTAGGGTGTC_GGGTACTGCAATAGGC	P
TCTAAGCGTATTGGTC_ATCCAGCGCTTGGACG_AGATGAACCGGCCCAT_CACACGTAGATTAAGT_TTGACAAGAAGGACAG	P
TCTAAGCGTATTGGTC_ATCCAGCGCTTGGACG_AGATGAACCGGCCCAT_AGGACCCCTTGTCACA_TACCGAACGTGGCCGG	P
TCTAAGCGTATTGGTC_ATCCAGCGCTTGGACG_AGATGAACCGGCCCAT_AGGACCCCTTGTCACA_TCTCGCGCTCGTTAAA	P
TCTAAGCGTATTGGTC_ATCCAGCGCTTGGACG_AGATGAACCGGCCCAT_AGGACCCCTTGTCACA_ACTTTCAATAGGATAA	P
ATAATGAGTGCACCTT_CAAGCATACTTATATG_TCATTCAAGGTTCCAA_CCTTTGAATCAGTGGG_CAGGAGCAGAAGAGTC	P
ATAATGAGTGCACCTT_CAAGCATACTTATATG_TCATTCAAGGTTCCAA_CCTTTGAATCAGTGGG_CTTTCTCCGAAACGGA	P
ATAATGAGTGCACCTT_CAAGCATACTTATATG_TCATTCAAGGTTCCAA_CCTTTGAATCAGTGGG_CAGTACACGAAACCAA	P
TAGTGACTTAGACCTG_CTTATCAACGGTGCTA_CAACCTGTAATTCTGC_TCCGGCGGAAACTCGT_ATCGATCACGGACCCT	P
ATAATGAGTGCACCTT_CAAGCATACTTATATG_ACGTCTTAAGCCGCAT_GCGGAATAACCCGTCT_GACTTAGACTCGGAAC	P
TAGTGACTTAGACCTG_CTTATCAACGGTGCTA_CAACCTGTAATTCTGC_CCCGTAAGGTAGCTCC_TGCTATAGCAAACCCG	A;R(P)
TAGTGACTTAGACCTG_CTTATCAACGGTGCTA_AAGATTCAGCGTATAA_TACCGTCTGATCTGTA_GATCAACGTCTCCAGA	P
TAGTGACTTAGACCTG_CTTATCAACGGTGCTA_AAGATTCAGCGTATAA_TACCGTCTGATCTGTA_TGCACAGCTCCCGGAC	A
TAGTGACTTAGACCTG_CTTATCAACGGTGCTA_AAGATTCAGCGTATAA_TACCGTCTGATCTGTA_CTGAGTAAAAGGGACT	A
TAGTGACTTAGACCTG_CTTATCAACGGTGCTA_AAGATTCAGCGTATAA_TACCGTCTGATCTGTA_TCTGGTCACCGGCTGT	P
