BC	flags
TTTGGCAACCTGGGTG_TATTGCAGTTATGCAG_TAGCAATAAACACGCT_TGACCGATGACCCGAC	B;R(P)
TTTGGCAACCTGGGTG_TATTGCAGTTATGCAG_TGTTAATCAGGGGGAG_TGGCATGTAACCGCTC	P
TTTGGCAACCTGGGTG_TATTGCAGTTATGCAG_TGTTAATCAGGGGGAG_CACTCCGGCTCTAGTT	P
TTTGGCAACCTGGGTG_TATTGCAGTTATGCAG_TGTTAATCAGGGGGAG_GTCCCAAACAGAGTGA	P
TTTGGCAACCTGGGTG_TATTGCAGTTATGCAG_TGTTAATCAGGGGGAG_TACGAAAGTGACAATA	P
TACAGGGGATGAAGCT_GTTGATTGGACGGATG_CGGTTTGGGCTCACCT_ACCGGGTAGTCGATAA	B
TTTGGCAACCTGGGTG_TATTGCAGTTATGCAG_TGTCGGTAAATCTAGT_ACGGGTAAAGAGTTCG	B;R(P)
TTTGGCAACCTGGGTG_TATTGCAGTTATGCAG_TCCGATGGCTTCGAGT_AACCACCGTGTTATCT	P
TTTGGCAACCTGGGTG_TATTGCAGTTATGCAG_TCCGATGGCTTCGAGT_CCCGCACAATGCTCTT	P
TTTGGCAACCTGGGTG_TATTGCAGTTATGCAG_TCCGATGGCTTCGAGT_TAGATGGGTTCTGAGC	P
ATAATGAGTGCACCTT_CAAGCATACTTATATG_ACGTCTTAAGCCGCAT_GCGGAATAACCCGTCT	P;R(B+)
ATAATGAGTGCACCTT_CAAGCATACTTATATG_ACGTCTTAAGCCGCAT_AAGAGGCAAGACTGTA	P
TTTGGCAACCTGGGTG_TATTGCAGTTATGCAG_TTCAGGTGGAAAATAT_CAATTGGTGTAACATG	P
TTTGGCAACCTGGGTG_TATTGCAGTTATGCAG_CTCAAGAATCGCGTAT_GGTACAGGGGGTGCAG	P
CCTGGAGCAGTCTAAT_CTGTGTCCAGCCTCGT_CCACTAATCGCCACAT_ATGTCGGCGGAAAATC	P
CCTGGAGCAGTCTAAT_CTGTGTCCAGCCTCGT_CCACTAATCGCCACAT_CGGTTAGCCCCGCGTG	P
TTTGGCAACCTGGGTG_TATTGCAGTTATGCAG_CAACCACCCGCATTCA_TGAGGGAACCCCTTGA	C
TTTGGCAACCTGGGTG_TATTGCAGTTATGCAG_AGGCAAACCTCTCTGT_ACGGCCAGAGGCATCA	P
TTTGGCAACCTGGGTG_TATTGCAGTTATGCAG_TAAGACATGGCGCAGC_GTAGGATGTTACGCGA	P
TTTGGCAACCTGGGTG_TATTGCAGTTATGCAG_TAAGACATGGCGCAGC_CGATTGTATAGAAGTA	P
TACCTAGTTTACAGAC_AAAGATAGGGTCTCTA_AGTGCGGTCCCATTTC_AGAGGTAACACTCTTT	B;R(P)
TACTTTGCGTCGTCAA_GCTTCTGGGGAAGTAT_AAAAACCCACTTCTCC_GTTGCCTCGCGTTCCT	P
TACAGGGGATGAAGCT_GTTGATTGGACGGATG_ATTACATATGCACGCC_ATTTCGGGGACGCGCC	A
GCATCGTACACCGGAT_GATCCACAGCCTGTAT_ATCAGTAAACTTTCAA_GTGGTAATCGCTCTGA	A
CCTGGAGCAGTCTAAT_CTGTGTCCAGCCTCGT_CTCCGCCGTCCGCATT_ACGCTCGATATCATGC	P
AGGGCGTCTCCAGAAT_CAGTGAGCGCCCGTCT_TTATAGTGAAAGAAGT_TATGAGTCCCTTAAGC	P
TACTTTGCGTCGTCAA_GCTTCTGGGGAAGTAT_TGGCTCATGGATACAT_TCGAGCATTTAACAGA	P
TAGTGACTTAGACCTG_CTTATCAACGGTGCTA_AAGGGTCCCCGAATTA_TCGATGTTCGCCCCTC	P
TAGTGACTTAGACCTG_CTTATCAACGGTGCTA_AAGGGTCCCCGAATTA_TCGACCTCGCTCTGAT	P
TTTGGCAACCTGGGTG_TATTGCAGTTATGCAG_AACCAAGCCTATTGTA_TTCAAAGAGGAGAACC	P
ATAGAATGGCTAAAAA_AGACCAGCTTATCAGT_CCAGCTCCCTTTCCGT_ATGACCGGGTAGAATG	P
TCTAAGCGTATTGGTC_ATCCAGCGCTTGGACG_GCAAGTGATGGTTGTT_CGGAGGGCCTTATGAT	P
TGCTCCACACGAGTCC_CCTTTGGGGTGAGACC_AATAGCGATCCAAAGT_CGCGCCTGGTCATCTT	P
CATCCGTTCCTGTAGA_AGGTCGAATCCCTCTT_CATTCGCATCTGGGAG_CGCCCTATAATGGGTG	P
TTTGGCAACCTGGGTG_TATTGCAGTTATGCAG_AACTGTGAGAGACCGT_GAGTAGTTCATGTGGC	P
TACAGGGGATGAAGCT_GTTGATTGGACGGATG_ATGTGTGCATAGAGTG_ACTTTGGGCCACAGCA	A;R(P)
TCTAAGCGTATTGGTC_ATCCAGCGCTTGGACG_AGATGAACCGGCCCAT_GTATGCACTAGGCGGC	P
TCTAAGCGTATTGGTC_ATCCAGCGCTTGGACG_AGATGAACCGGCCCAT_TCTGGATGGGTACTTT	P
TCTAAGCGTATTGGTC_ATCCAGCGCTTGGACG_AGATGAACCGGCCCAT_GGTCTCCAAAAGCGGT	C
TCTAAGCGTATTGGTC_ATCCAGCGCTTGGACG_AGATGAACCGGCCCAT_AGGACCCCTTGTCACA	P
TCTAAGCGTATTGGTC_ATCCAGCGCTTGGACG_AGATGAACCGGCCCAT_AAATTGTTAGGGTGTC	P
TCTAAGCGTATTGGTC_ATCCAGCGCTTGGACG_AGATGAACCGGCCCAT_CACACGTAGATTAAGT	P
TCTAAGCGTATTGGTC_ATCCAGCGCTTGGACG_AGATGAACCGGCCCAT_AGTGCATACTTAGTAG	P
TCTAAGCGTATTGGTC_ATCCAGCGCTTGGACG_AGATGAACCGGCCCAT_TCGGCTAAAGGTTGCG	P
TCTAAGCGTATTGGTC_ATCCAGCGCTTGGACG_AGATGAACCGGCCCAT_TACAAGCAGTAGGACA	P
TCTAAGCGTATTGGTC_ATCCAGCGCTTGGACG_AGATGAACCGGCCCAT_TGTGGATGCCCGCCCC	P
TCTAAGCGTATTGGTC_ATCCAGCGCTTGGACG_AGATGAACCGGCCCAT_TACAGGAGGACAGATC	P
TCTAAGCGTATTGGTC_ATCCAGCGCTTGGACG_AGATGAACCGGCCCAT_ACCAAGGTACTTGTCC	P
TAGTGACTTAGACCTG_CTTATCAACGGTGCTA_TGCCTCGAAGGCCTAT_TCACAGCTCAGTTCGT	P
TAGTGACTTAGACCTG_CTTATCAACGGTGCTA_TGCCTCGAAGGCCTAT_CTGAAGCAGGTTCTTA	P;R(B+)
TAGTGACTTAGACCTG_CTTATCAACGGTGCTA_TGCCTCGAAGGCCTAT_GAGGGGGAGTGTCTTC	P
TAGTGACTTAGACCTG_CTTATCAACGGTGCTA_TGCCTCGAAGGCCTAT_ATAGGGGTCGGACAAA	P
TAGTGACTTAGACCTG_CTTATCAACGGTGCTA_TGCCTCGAAGGCCTAT_CGTGGAATTGATCCGC	P
TAGTGACTTAGACCTG_CTTATCAACGGTGCTA_TGCCTCGAAGGCCTAT_CACTCGCGAACGAACA	P
TAGTGACTTAGACCTG_CTTATCAACGGTGCTA_TGCCTCGAAGGCCTAT_CAGGACTACGGTCTAC	P
TAGTGACTTAGACCTG_CTTATCAACGGTGCTA_TGCCTCGAAGGCCTAT_GTTACCCTGGTCGAAC	P
TAGTGACTTAGACCTG_CTTATCAACGGTGCTA_TGCCTCGAAGGCCTAT_CAGCAACCGCGTTACA	C
TAGTGACTTAGACCTG_CTTATCAACGGTGCTA_TGCCTCGAAGGCCTAT_CCGGGGTACGTACCCG	P
TAGTGACTTAGACCTG_CTTATCAACGGTGCTA_TGCCTCGAAGGCCTAT_GCTAGGCCAGTGTGAT	P
TAGTGACTTAGACCTG_CTTATCAACGGTGCTA_TGCCTCGAAGGCCTAT_ATGCTCCCGATCAAAT	P
TAGTGACTTAGACCTG_CTTATCAACGGTGCTA_TGCCTCGAAGGCCTAT_ACTGACCAGAACTGCA	P
TAGTGACTTAGACCTG_CTTATCAACGGTGCTA_TGCCTCGAAGGCCTAT_CGGGGTAGGCGGGGAC	P
TGCTCCACACGAGTCC_CCTTTGGGGTGAGACC_GCACGTTAGTGCTATC_AGCCAAGCGTTCCATC	P
ATAATGAGTGCACCTT_CAAGCATACTTATATG_CTGACAGCCGAGCCCT_CGGGCGTGCTTCTTGG	P
ATAATGAGTGCACCTT_CAAGCATACTTATATG_CTGACAGCCGAGCCCT_GTAACGATAAAGAGCA	P
ATAATGAGTGCACCTT_CAAGCATACTTATATG_CTGACAGCCGAGCCCT_TTCCTGAGAAGATTGC	C
TCTAAGCGTATTGGTC_ATCCAGCGCTTGGACG_TCTCCGCTACGCGAGT_ATTGCCCGACTTTAGC	A
ATAATGAGTGCACCTT_CAAGCATACTTATATG_ACGTCTTAAGCCGCAT_AAAGAGTAGCTCACAG	P
ATAATGAGTGCACCTT_CAAGCATACTTATATG_ACGTCTTAAGCCGCAT_GTGTACCCGTCCTTTC	P
ATAATGAGTGCACCTT_CAAGCATACTTATATG_ACGTCTTAAGCCGCAT_GTGGTCCCGATGTTTC	P
ATAATGAGTGCACCTT_CAAGCATACTTATATG_ACGTCTTAAGCCGCAT_TCTGAGCCCCGAAGTC	P
ATAATGAGTGCACCTT_CAAGCATACTTATATG_ACGTCTTAAGCCGCAT_AGCTTGACCTGCAATG	P
ATAATGAGTGCACCTT_CAAGCATACTTATATG_ACGTCTTAAGCCGCAT_GTCTTAAGATTGGCGT	P
TACTTTGCGTCGTCAA_GCTTCTGGGGAAGTAT_ACGCGCAGACATATCT_CACACAACGACATGGC	P
TACTTTGCGTCGTCAA_GCTTCTGGGGAAGTAT_ATCGGCCCGTGTTACT_TTTAACGAGTATGCCG	P
ATAATGAGTGCACCTT_CAAGCATACTTATATG_TCATTCAAGGTTCCAA_GCGGTAACGGTGGCTG	P
ATAATGAGTGCACCTT_CAAGCATACTTATATG_TCATTCAAGGTTCCAA_CCTTTGAATCAGTGGG	P
ATAATGAGTGCACCTT_CAAGCATACTTATATG_TCATTCAAGGTTCCAA_TATCGTTGAGCATGCA	P
TACAGGGGATGAAGCT_GTTGATTGGACGGATG_CAGCCCATACAAGAAT_GATGAATGAACGCGTA	P
AGCTATACCCCAACAA_CTGATTTCTGAGACTG_TACCTACAGACAATCT_CTGATTAGGCCTAGGA	P
TACTTTGCGTCGTCAA_GCTTCTGGGGAAGTAT_GGACCACTCAATGAGT_CTTGCGGCATTACCGA	P
TACTTTGCGTCGTCAA_GCTTCTGGGGAAGTAT_GGACCACTCAATGAGT_TCTGGCGTGCGCCGGA	P
TTTGGCAACCTGGGTG_TATTGCAGTTATGCAG_AATCAGCAGCCTCGAC_AAGAATGAAGGGCATA	P
ACTGTACCTGCGGGTT_TGCGCCTTGTGATGTA_AAGAGCTTCGTTACGT_CCCCCATGGATTGGCT	P
TACAGGGGATGAAGCT_GTTGATTGGACGGATG_CGCCACTCATGCACCA_CGAGTTGCGCTAAAGA	P
TTTGGCAACCTGGGTG_TATTGCAGTTATGCAG_AAGTTAGTAAGTTAAT_GTGGACCACATAAATG	P
TTTGGCAACCTGGGTG_TATTGCAGTTATGCAG_AAGTTAGTAAGTTAAT_ATTGGACGCGACGCGG	P
TTTGGCAACCTGGGTG_TATTGCAGTTATGCAG_AAGTTAGTAAGTTAAT_CAGTCACTCACAATGT	P
TAGTGACTTAGACCTG_CTTATCAACGGTGCTA_AAGATTCAGCGTATAA_ACCTAGCCGGCCATTA	P
TAGTGACTTAGACCTG_CTTATCAACGGTGCTA_AAGATTCAGCGTATAA_CAAATTAAAGGGTCAT	P
TAGTGACTTAGACCTG_CTTATCAACGGTGCTA_AAGATTCAGCGTATAA_CCAACGCAAAGATAAC	P
TAGTGACTTAGACCTG_CTTATCAACGGTGCTA_AAGATTCAGCGTATAA_TACCGTCTGATCTGTA	C
TAGTGACTTAGACCTG_CTTATCAACGGTGCTA_AAGATTCAGCGTATAA_CAAAACGACGCCAATC	P
TACAGGGGATGAAGCT_GTTGATTGGACGGATG_CCAAAAATCGTCCCTT_GGTGATCTAGCGAGTC	P
CCTGGAGCAGTCTAAT_CTGTGTCCAGCCTCGT_CCACTAATCGCCACAT_CCAGGCGGTATTTCCC	P
CCTGGAGCAGTCTAAT_CTGTGTCCAGCCTCGT_CCACTAATCGCCACAT_AGGACGGCCCACTGTT	P
TCTAAGCGTATTGGTC_ATCCAGCGCTTGGACG_GCGAATTTCAGACAGT_ACAATTGAAACAGCTC	P
TTTGGCAACCTGGGTG_TATTGCAGTTATGCAG_TCTGGCGTTCTGCCTA_CTTGCTCCCGGGTATG	P
TTTGGCAACCTGGGTG_TATTGCAGTTATGCAG_AGGCAAACCTCTCTGT_GACTGACTGTCTCGCA	P
ATAATGAGTGCACCTT_CAAGCATACTTATATG_AGTGACCAAGGATCGG_ACCGCCCCAATAACTG	P
ATAATGAGTGCACCTT_CAAGCATACTTATATG_AGTGACCAAGGATCGG_CCAACGTCTGCCTGGA	P
TACTTTGCGTCGTCAA_GCTTCTGGGGAAGTAT_TGCACGTAGCATTAGT_AAATCCAACAAATCTT	P
TACTTTGCGTCGTCAA_GCTTCTGGGGAAGTAT_AAAAACCCACTTCTCC_ATTAGGTGGGGGGCCC	P
TAGTGACTTAGACCTG_CTTATCAACGGTGCTA_ACCGTCCGTGCGCTTT_CAGCAAATATAGAGAA	P
TAGTGACTTAGACCTG_CTTATCAACGGTGCTA_ACCGTCCGTGCGCTTT_CTGACTGCCGAGCGGG	P
TAGTGACTTAGACCTG_CTTATCAACGGTGCTA_ACCGTCCGTGCGCTTT_GTTACAGATGAATGGG	P
CATCCGTTCCTGTAGA_AGGTCGAATCCCTCTT_ACGTACTTGTTAAAGC_TAGCTCCGCCGCTCGT	P
TAGTGACTTAGACCTG_CTTATCAACGGTGCTA_CCAGATGGAAATAAAC_CAACACACCCGCTTGA	P
TAGTGACTTAGACCTG_CTTATCAACGGTGCTA_CCAGATGGAAATAAAC_CCAATCGACTACGACT	P
TAGTGACTTAGACCTG_CTTATCAACGGTGCTA_CCAGATGGAAATAAAC_GGTCCCAGACCAGTTG	P
TTTGGCAACCTGGGTG_TATTGCAGTTATGCAG_CTCCAAACTGACGCCG_ATGGACATAAAACACG	P
GCATCGTACACCGGAT_GATCCACAGCCTGTAT_TAAAAGTGGAAGGTTT_GTCAATTGAGGGCCTG	P
ATCGTTGAATACACGC_CTTGCGCTCGAATGAT_AATTAGGGTTAGCCCC_CCACTAGCCGAGTGAG	P
ATCGTTGAATACACGC_CTTGCGCTCGAATGAT_AATTAGGGTTAGCCCC_TTAACTGCGGCAGCTT	A
TAGTGACTTAGACCTG_CTTATCAACGGTGCTA_CAACCTGTAATTCTGC_TCTGCTCCAAGCGTTT	P
TAGTGACTTAGACCTG_CTTATCAACGGTGCTA_CAACCTGTAATTCTGC_TCCGGCGGAAACTCGT	P
TAGTGACTTAGACCTG_CTTATCAACGGTGCTA_CAACCTGTAATTCTGC_GGCAGGTAGACCTTCA	C
TAGTGACTTAGACCTG_CTTATCAACGGTGCTA_CAACCTGTAATTCTGC_ATAGGCTGTGGAGGTC	P
TAGTGACTTAGACCTG_CTTATCAACGGTGCTA_CAACCTGTAATTCTGC_TTACGAGGTAGGGGGC	P
TAGTGACTTAGACCTG_CTTATCAACGGTGCTA_CAACCTGTAATTCTGC_AGGACACGCAAGAAAT	P
TAGTGACTTAGACCTG_CTTATCAACGGTGCTA_CAACCTGTAATTCTGC_GGGTCTATTCTTCATG	P
TAGTGACTTAGACCTG_CTTATCAACGGTGCTA_CAACCTGTAATTCTGC_CTAGGCGACGGTGACT	P
TAGTGACTTAGACCTG_CTTATCAACGGTGCTA_CAACCTGTAATTCTGC_CACTGCCCGTCCTAAC	P
TAGTGACTTAGACCTG_CTTATCAACGGTGCTA_CAACCTGTAATTCTGC_GTGCCAACTTAGTCAG	P
TAGTGACTTAGACCTG_CTTATCAACGGTGCTA_CAACCTGTAATTCTGC_TCCTACGTAGCTTGAG	P
TAGTGACTTAGACCTG_CTTATCAACGGTGCTA_CAACCTGTAATTCTGC_CTGGGGAAGCATGTAT	P
TAGTGACTTAGACCTG_CTTATCAACGGTGCTA_CAACCTGTAATTCTGC_CCCGTAAGGTAGCTCC	C;R(P)
GCATCGTACACCGGAT_GATCCACAGCCTGTAT_ATCAGTAAACTTTCAA_AGGGAGAAAACATAGC	P
GCATCGTACACCGGAT_GATCCACAGCCTGTAT_ATCAGTAAACTTTCAA_ATAGAGTAATAATCGA	P
GCATCGTACACCGGAT_GATCCACAGCCTGTAT_ATCAGTAAACTTTCAA_TAGCTAACCTGACGGA	P
ACTGTACCTGCGGGTT_TGCGCCTTGTGATGTA_TCCTGGGTGCTCAAGC_TCCTTGTGGAAAATGT	P
TTTGGCAACCTGGGTG_TATTGCAGTTATGCAG_ACTTGGCAGTGTGTCT_CGAGATGAGCCATAAT	P
