BC	flags
TACAGGGGATGAAGCT_GTTGATTGGACGGATG_ATTACATATGCACGCC_ATTTCGGGGACGCGCC_CTAGCTATGTTCACCC_CGGCCAACCTTCTGGA_AAAAGGCTCGTGGTGC	C
TTTGGCAACCTGGGTG_TATTGCAGTTATGCAG_CAACCACCCGCATTCA_TGAGGGAACCCCTTGA_ACGGTTATGTAACCGG_CCTGCCCCAGTAACCT_CTGCCCCACCCAGTCT	P
TTTGGCAACCTGGGTG_TATTGCAGTTATGCAG_CAACCACCCGCATTCA_TGAGGGAACCCCTTGA_ACGGTTATGTAACCGG_CCTGCCCCAGTAACCT_AAAATTCATATGGGCA	P
TTTGGCAACCTGGGTG_TATTGCAGTTATGCAG_CAACCACCCGCATTCA_TGAGGGAACCCCTTGA_ACGGTTATGTAACCGG_CCTGCCCCAGTAACCT_TCCCATAATGAACAGC	P
TTTGGCAACCTGGGTG_TATTGCAGTTATGCAG_CAACCACCCGCATTCA_TGAGGGAACCCCTTGA_ACGGTTATGTAACCGG_CCTGCCCCAGTAACCT_ACTCGACTACAACCGC	P
TTTGGCAACCTGGGTG_TATTGCAGTTATGCAG_CAACCACCCGCATTCA_TGAGGGAACCCCTTGA_ACGGTTATGTAACCGG_CCTGCCCCAGTAACCT_TATAGGGTTGGGGAGG	P
TTTGGCAACCTGGGTG_TATTGCAGTTATGCAG_CAACCACCCGCATTCA_TGAGGGAACCCCTTGA_ACGGTTATGTAACCGG_CCTGCCCCAGTAACCT_AACCCTGTATCAAACT	P;R(A)
GCATCGTACACCGGAT_GATCCACAGCCTGTAT_ATCAGTAAACTTTCAA_GTGGTAATCGCTCTGA_TGCCGCTTCCCCGCAC_ATTAGCGCCTCCCGAT_CTGTGACATAGGCAGT	B
TACAGGGGATGAAGCT_GTTGATTGGACGGATG_ATTACATATGCACGCC_ATTTCGGGGACGCGCC_CTTTTAGCGGCGGAGC_CTGGATTCTTCTCAGA_GTTGCATTGATTAAGC	P
TACAGGGGATGAAGCT_GTTGATTGGACGGATG_ATTACATATGCACGCC_ATTTCGGGGACGCGCC_CTGGGTTCACCTGTTG_TCTACCTTCAGATATT_CCATTACAACAAGCGG	P
GCATCGTACACCGGAT_GATCCACAGCCTGTAT_ATCAGTAAACTTTCAA_GTGGTAATCGCTCTGA_AGGAGACGTGAGATGT_TTAGGGCCGCGATCAA_AAGCGTTGGCTTGCAT	P;R(A)
TACAGGGGATGAAGCT_GTTGATTGGACGGATG_ATTACATATGCACGCC_ATTTCGGGGACGCGCC_TTATAGCGGAGCGGGA_AAGGGCGATGTGTTGT_CGCAGGCTAAAAGCAC	P
TACAGGGGATGAAGCT_GTTGATTGGACGGATG_ATTACATATGCACGCC_ATTTCGGGGACGCGCC_ACCTCTCGCATCCAAC_ACCAGAAATACATCTG_ACTGCGGTAACTTGTT	C
TAGTGACTTAGACCTG_CTTATCAACGGTGCTA_CAACCTGTAATTCTGC_GGCAGGTAGACCTTCA_GAGAAGAATGGAATGA_GCAATACGTCTTAAGT_AGCGGTTCGGCTTAAG	P
TCTAAGCGTATTGGTC_ATCCAGCGCTTGGACG_TCTCCGCTACGCGAGT_ATTGCCCGACTTTAGC_AAGCCGAGGCTATTTC_GACTAGTGGTGTGTAG_CTGGGGATTGTGGTAT	A
TCTAAGCGTATTGGTC_ATCCAGCGCTTGGACG_TCTCCGCTACGCGAGT_ATTGCCCGACTTTAGC_AAGCCGAGGCTATTTC_GACTAGTGGTGTGTAG_CAAAGATTATATGTGC	P
TACAGGGGATGAAGCT_GTTGATTGGACGGATG_ATTACATATGCACGCC_ATTTCGGGGACGCGCC_GAGCCAACTACGTACA_TACCTTCGAAGCGTCA_GGATTGATTAGTTAGG	P
TACAGGGGATGAAGCT_GTTGATTGGACGGATG_ATTACATATGCACGCC_ATTTCGGGGACGCGCC_GAGCCAACTACGTACA_TACCTTCGAAGCGTCA_TGCCGGTGGCAATACT	P
TACAGGGGATGAAGCT_GTTGATTGGACGGATG_ATTACATATGCACGCC_ATTTCGGGGACGCGCC_GAGCCAACTACGTACA_CGATTGTATTGCGCGC_CCGGATTAATCGTAAA	P
TACAGGGGATGAAGCT_GTTGATTGGACGGATG_ATTACATATGCACGCC_ATTTCGGGGACGCGCC_TTCAAGCCTTACGGAC_CTTGCCGATAGGCTTC_AACGCGAAGCGTCACC	P
GCATCGTACACCGGAT_GATCCACAGCCTGTAT_ATCAGTAAACTTTCAA_GTGGTAATCGCTCTGA_TGCCGCTTCCCCGCAC_CACATAAGCATGCAGA_GTCACTGTGCCGCTAT	A
TACAGGGGATGAAGCT_GTTGATTGGACGGATG_ATTACATATGCACGCC_ATTTCGGGGACGCGCC_GAGCCAACTACGTACA_TTGAGACTTGGATCGC_GGGCGAAGAACGGTTT	P
GCATCGTACACCGGAT_GATCCACAGCCTGTAT_ATCAGTAAACTTTCAA_GTGGTAATCGCTCTGA_TGCCGCTTCCCCGCAC_TCCCCTCGCATACGAC_TGAGAATACAAGCCCA	P
GCATCGTACACCGGAT_GATCCACAGCCTGTAT_ATCAGTAAACTTTCAA_GTGGTAATCGCTCTGA_TACAGGTCTGCGCATC_CAGGGCATCTCGTGAT_CTAGCAGGCTCACCAT	P
GCATCGTACACCGGAT_GATCCACAGCCTGTAT_ATCAGTAAACTTTCAA_GTGGTAATCGCTCTGA_CAGTAACGATTTGGCA_CGTAGAACAACTCAGG_CAGCTATAGGGTTCGT	P
GCATCGTACACCGGAT_GATCCACAGCCTGTAT_ATCAGTAAACTTTCAA_GTGGTAATCGCTCTGA_CAGTAACGATTTGGCA_CGTAGAACAACTCAGG_CTGTTGTGTGTCCGCT	P
ATAATGAGTGCACCTT_CAAGCATACTTATATG_CTGACAGCCGAGCCCT_TTCCTGAGAAGATTGC_GACCCTCAACACATCG_GGGTCCAAAGGTAAAC_ATACATTACAAATTGG	P
ATAATGAGTGCACCTT_CAAGCATACTTATATG_CTGACAGCCGAGCCCT_TTCCTGAGAAGATTGC_GACCCTCAACACATCG_GGGTCCAAAGGTAAAC_CCACCGGGAGAGAATT	P
ATAATGAGTGCACCTT_CAAGCATACTTATATG_CTGACAGCCGAGCCCT_TTCCTGAGAAGATTGC_GACCCTCAACACATCG_GGGTCCAAAGGTAAAC_ACACATTGGGCAGCCC	P;R(A)
ATAATGAGTGCACCTT_CAAGCATACTTATATG_CTGACAGCCGAGCCCT_TTCCTGAGAAGATTGC_GACCCTCAACACATCG_GGGTCCAAAGGTAAAC_AAGGATTCTATGCGTT	P
ATAATGAGTGCACCTT_CAAGCATACTTATATG_CTGACAGCCGAGCCCT_TTCCTGAGAAGATTGC_GACCCTCAACACATCG_GGGTCCAAAGGTAAAC_CATGCTGCCCCAGCCG	P
GCATCGTACACCGGAT_GATCCACAGCCTGTAT_ATCAGTAAACTTTCAA_GTGGTAATCGCTCTGA_TACAGGTCTGCGCATC_TCGTGCTGAATGTCAT_TACGATCGCGGTCAAA	P
GCATCGTACACCGGAT_GATCCACAGCCTGTAT_ATCAGTAAACTTTCAA_GTGGTAATCGCTCTGA_TACAGGTCTGCGCATC_TCGTGCTGAATGTCAT_GGGGTACATTGTATGG	P
GCATCGTACACCGGAT_GATCCACAGCCTGTAT_ATCAGTAAACTTTCAA_GTGGTAATCGCTCTGA_TACAGGTCTGCGCATC_TCGTGCTGAATGTCAT_TCCTAAGGACGGCAAA	P
GCATCGTACACCGGAT_GATCCACAGCCTGTAT_ATCAGTAAACTTTCAA_GTGGTAATCGCTCTGA_AAACCAGGTGACGTTG_AACTAGCAAACGTCAA_AATAAGAAGGGTGTAT	P
GCATCGTACACCGGAT_GATCCACAGCCTGTAT_ATCAGTAAACTTTCAA_GTGGTAATCGCTCTGA_GTACCTCTGACCCAAT_ATTGGTGAGGAGGGCT_TTTCAGTTGGTCTAAA	P
TTTGGCAACCTGGGTG_TATTGCAGTTATGCAG_CAACCACCCGCATTCA_TGAGGGAACCCCTTGA_ACGGTTATGTAACCGG_CCTGCCCCAGTAACCT_GTGTAGCGCGCAAAAG	P
TACAGGGGATGAAGCT_GTTGATTGGACGGATG_ATTACATATGCACGCC_ATTTCGGGGACGCGCC_TAGAGACGCCCCCGAC_TGCAGTGACTCAGTTA_TCTGATTTGATTGTCA	P
TACAGGGGATGAAGCT_GTTGATTGGACGGATG_ATTACATATGCACGCC_ATTTCGGGGACGCGCC_TAGTCACCGCAGACCA_AATGAGTCCGGTAGAA_GTTGCACCACCGAGAC	P
TACAGGGGATGAAGCT_GTTGATTGGACGGATG_ATTACATATGCACGCC_ATTTCGGGGACGCGCC_AACTGGCCAAATGACC_ACTGCATAACTAATGG_AGGCTAAGCAAACAAG	P
TACAGGGGATGAAGCT_GTTGATTGGACGGATG_ATTACATATGCACGCC_ATTTCGGGGACGCGCC_TAGCGACGGTAATTCC_TGCGTGGCGAGCGCGT_TTATCGCACCGCGCAT	P
TACAGGGGATGAAGCT_GTTGATTGGACGGATG_ATTACATATGCACGCC_ATTTCGGGGACGCGCC_TCAGGGGAGGTTCGTC_CGGACCTAGGAGAACG_TCTACAGCGTAACAGG	P
TACAGGGGATGAAGCT_GTTGATTGGACGGATG_ATTACATATGCACGCC_ATTTCGGGGACGCGCC_TCAGGGGAGGTTCGTC_CGGACCTAGGAGAACG_TGGGAAGAGGTGGCAC	P
TACAGGGGATGAAGCT_GTTGATTGGACGGATG_ATTACATATGCACGCC_ATTTCGGGGACGCGCC_TCAGGGGAGGTTCGTC_CGGACCTAGGAGAACG_AGCGTTTGTTAGTGCC	P
TACAGGGGATGAAGCT_GTTGATTGGACGGATG_ATTACATATGCACGCC_ATTTCGGGGACGCGCC_TCAGGGGAGGTTCGTC_CGGACCTAGGAGAACG_TGGGGGTATGAATTCG	C
TACAGGGGATGAAGCT_GTTGATTGGACGGATG_ATTACATATGCACGCC_ATTTCGGGGACGCGCC_TCAGGGGAGGTTCGTC_CGGACCTAGGAGAACG_ATCCGACCATCGACCT	P
TACAGGGGATGAAGCT_GTTGATTGGACGGATG_ATTACATATGCACGCC_ATTTCGGGGACGCGCC_TCAGGGGAGGTTCGTC_CGGACCTAGGAGAACG_AGGGGCGGGCAAGGAG	P
TACAGGGGATGAAGCT_GTTGATTGGACGGATG_ATTACATATGCACGCC_ATTTCGGGGACGCGCC_CTGTTCGCATCTTTCC_ATAAAACAGCGCAAGA_ACTGGAAAATAGTGTG	P
GCATCGTACACCGGAT_GATCCACAGCCTGTAT_ATCAGTAAACTTTCAA_GTGGTAATCGCTCTGA_CAGTAACGATTTGGCA_CAAATTACTGAGCGTA_ACGCCTTTGGGCAGAA	P
GCATCGTACACCGGAT_GATCCACAGCCTGTAT_ATCAGTAAACTTTCAA_GTGGTAATCGCTCTGA_CAGTAACGATTTGGCA_CAAATTACTGAGCGTA_TCTGGCGGGAATGTAA	P
TACAGGGGATGAAGCT_GTTGATTGGACGGATG_ATTACATATGCACGCC_ATTTCGGGGACGCGCC_TGGTAACCGGGTCCTT_TCCGCCAGTGTACTTA_TCCGGTGTCCGGAACA	P
TACAGGGGATGAAGCT_GTTGATTGGACGGATG_ATTACATATGCACGCC_ATTTCGGGGACGCGCC_TGGTAACCGGGTCCTT_TCCGCCAGTGTACTTA_CCAGGATACCGCAGTT	P
TACAGGGGATGAAGCT_GTTGATTGGACGGATG_ATTACATATGCACGCC_ATTTCGGGGACGCGCC_TGGTAACCGGGTCCTT_TCCGCCAGTGTACTTA_AGCGCCTGGAGGTCAA	P
TACAGGGGATGAAGCT_GTTGATTGGACGGATG_ATTACATATGCACGCC_ATTTCGGGGACGCGCC_TGGTAACCGGGTCCTT_TCCGCCAGTGTACTTA_CCCAAGGGTAAGGTCG	P
TACAGGGGATGAAGCT_GTTGATTGGACGGATG_ATTACATATGCACGCC_ATTTCGGGGACGCGCC_TGGTAACCGGGTCCTT_TCCGCCAGTGTACTTA_CTTCTGTCGCCACCCG	P
TACAGGGGATGAAGCT_GTTGATTGGACGGATG_ATTACATATGCACGCC_ATTTCGGGGACGCGCC_TGGTAACCGGGTCCTT_TCCGCCAGTGTACTTA_TAGTGAGGCCTGTGGA	P
TACAGGGGATGAAGCT_GTTGATTGGACGGATG_ATTACATATGCACGCC_ATTTCGGGGACGCGCC_TGGTAACCGGGTCCTT_ATGGCGGCATGCCAGG_AAGTGTCGTTTGCTAT	P
TACAGGGGATGAAGCT_GTTGATTGGACGGATG_ATTACATATGCACGCC_ATTTCGGGGACGCGCC_AGATAAACTGATTGCT_ACCTCAATCATCCTCA_GTTGTAGTTACGTTGA	P
TACAGGGGATGAAGCT_GTTGATTGGACGGATG_ATTACATATGCACGCC_ATTTCGGGGACGCGCC_AGATAAACTGATTGCT_ACCTCAATCATCCTCA_ATGTGAAGGTAAGAAA	P
TACAGGGGATGAAGCT_GTTGATTGGACGGATG_ATTACATATGCACGCC_ATTTCGGGGACGCGCC_AGATAAACTGATTGCT_ACCTCAATCATCCTCA_TGAATTCGTGCAGACC	P
TACAGGGGATGAAGCT_GTTGATTGGACGGATG_ATTACATATGCACGCC_ATTTCGGGGACGCGCC_AGATAAACTGATTGCT_ACCTCAATCATCCTCA_CAGTCTGAAGTAAACG	P
TACAGGGGATGAAGCT_GTTGATTGGACGGATG_ATTACATATGCACGCC_ATTTCGGGGACGCGCC_AGATAAACTGATTGCT_ACCTCAATCATCCTCA_GTGGTCATATTGTCAA	P
TCTAAGCGTATTGGTC_ATCCAGCGCTTGGACG_AGATGAACCGGCCCAT_GGTCTCCAAAAGCGGT_TGGCGTCGGCGCAGCC_TTGGCCGCGGGCGCAA_TTAAAAGACATCGGTA	A
