BC	flags
TACAGGGGATGAAGCT_GTTGATTGGACGGATG	A
CCTGGAGCAGTCTAAT_CTGTGTCCAGCCTCGT	A
AGCTATACCCCAACAA_ACTCTACACCCGAATG	P
TTTGGCAACCTGGGTG_TATTGCAGTTATGCAG	A
GCATCGTACACCGGAT_GATCCACAGCCTGTAT	A
CATCCGTTCCTGTAGA_AGGTCGAATCCCTCTT	A
TGCTCCACACGAGTCC_CCTTTGGGGTGAGACC	A
ATAATGAGTGCACCTT_CAAGCATACTTATATG	A
ACGAGGCGTGTAATCA_GCGATGTCGCCCCACC	P
GTCTTGGCTCCGATTG_TAAAGCAGAGCACATG	A
TAGTTCGCCGGAGCCA_TCTCTAAAAGCGCTAA	A;R(N)
AGGGCGTCTCCAGAAT_CAGTGAGCGCCCGTCT	A
ATCGTTGAATACACGC_CTTGCGCTCGAATGAT	A
GCCGGCCCTATACGAA_TCCTCGTGTGGTCAAT	A
ACGCCACGCGTCTCAG_CAGGCGTCGTGGGTCA	C
TCTAAGCGTATTGGTC_ATCCAGCGCTTGGACG	A
AATAGTTCTGGGGACC_AAGACCCGGAAATCAG	A
TAGTGACTTAGACCTG_CTTATCAACGGTGCTA	A
AACCGCGATTGCATAG_GTTACAGTGGTCGTCG	C
ATAGAATGGCTAAAAA_AGACCAGCTTATCAGT	C
AGCTATACCCCAACAA_CTGATTTCTGAGACTG	C
GCCGTGCCAAAGTAGG_TTGGAGATCACAAGCA	A
ACTGTACCTGCGGGTT_TGCGCCTTGTGATGTA	A
GCATAGGGGGGAGCAC_CCTGCCTGTACTGTTG	A
GGCGAGAACTTAATGG_GTGCTCGCAACTTTAC	A
ATGGGGATGGCTGGCC_CCCCACTAGGTACTAT	A
TACCTAGTTTACAGAC_AAAGATAGGGTCTCTA	A
GGTGGCCTCATAGTAC_CATTAAGGGAGCGCTC	A
ACTCGATCTCGCCGCC_CGGGGAAATTGCAAAC	A
CAGGACTAACTCTCCG_GCCTTCGGTCAAGCCA	C
TACGGAGCGAACAGTT_TCTTCCGAAGTTGGAC	A
GGGGAAGTGTCCGGCA_TTTGTCAACCAGTAGT	A
TACTTTGCGTCGTCAA_GCTTCTGGGGAAGTAT	A
TAGCACTCTGTGTCTA_CTCATGAGGACGAGGC	C
AGACCTATATCGCAAT_CGCGTCAGGGTGCTAG	A
