BC	flags
GCATCGTACACCGGAT_GATCCACAGCCTGTAT_ATCAGTAAACTTTCAA_GTGGTAATCGCTCTGA_CAGTAACGATTTGGCA_CGGTCCGCTGCTCGAG	P
TACAGGGGATGAAGCT_GTTGATTGGACGGATG_ATTACATATGCACGCC_ATTTCGGGGACGCGCC_AGAGTCAGCTAGTATT_CAACCACAACCTAAAC	B
TACAGGGGATGAAGCT_GTTGATTGGACGGATG_ATTACATATGCACGCC_ATTTCGGGGACGCGCC_TGGTAACCGGGTCCTT_CTATGCGCTCGGGAAA	B
TACAGGGGATGAAGCT_GTTGATTGGACGGATG_ATTACATATGCACGCC_ATTTCGGGGACGCGCC_TGGTAACCGGGTCCTT_TCCGCCAGTGTACTTA	A
TACAGGGGATGAAGCT_GTTGATTGGACGGATG_ATTACATATGCACGCC_ATTTCGGGGACGCGCC_CTAGCTATGTTCACCC_CGGCCAACCTTCTGGA	B
ATAATGAGTGCACCTT_CAAGCATACTTATATG_CTGACAGCCGAGCCCT_TTCCTGAGAAGATTGC_GACCCTCAACACATCG_GGGTCCAAAGGTAAAC	A
GCATCGTACACCGGAT_GATCCACAGCCTGTAT_ATCAGTAAACTTTCAA_GTGGTAATCGCTCTGA_AAACCAGGTGACGTTG_TGACGCAGGGACTACC	P;R(B)
GCATCGTACACCGGAT_GATCCACAGCCTGTAT_ATCAGTAAACTTTCAA_GTGGTAATCGCTCTGA_AGGAGACGTGAGATGT_TTAGGGCCGCGATCAA	P;R(B)
TTTGGCAACCTGGGTG_TATTGCAGTTATGCAG_CAACCACCCGCATTCA_TGAGGGAACCCCTTGA_ACGGTTATGTAACCGG_CCTGCCCCAGTAACCT	P
TCTAAGCGTATTGGTC_ATCCAGCGCTTGGACG_AGATGAACCGGCCCAT_TACAAGCAGTAGGACA_GCCAGCTTCCAACGCG_GAGGTTATAGATGGCA	P
TACAGGGGATGAAGCT_GTTGATTGGACGGATG_ATTACATATGCACGCC_ATTTCGGGGACGCGCC_AGCGGAAATTGCGTCT_TACGCTCTACGACGGT	P
TACAGGGGATGAAGCT_GTTGATTGGACGGATG_ATTACATATGCACGCC_ATTTCGGGGACGCGCC_AGCGGAAATTGCGTCT_TTCTTACCGGTGCCAC	P
TAGTGACTTAGACCTG_CTTATCAACGGTGCTA_AAGATTCAGCGTATAA_TACCGTCTGATCTGTA_TCTGGTCACCGGCTGT_TGCGGTGTACAAATTA	P
TCTAAGCGTATTGGTC_ATCCAGCGCTTGGACG_TCTCCGCTACGCGAGT_ATTGCCCGACTTTAGC_ATTGCACGAAGGGGCA_CCAGAAAAGACGTTGC	P
TCTAAGCGTATTGGTC_ATCCAGCGCTTGGACG_TCTCCGCTACGCGAGT_ATTGCCCGACTTTAGC_TCGTGGATGGAGAGTC_GGGACATGTCGACGCC	P
TCTAAGCGTATTGGTC_ATCCAGCGCTTGGACG_TCTCCGCTACGCGAGT_ATTGCCCGACTTTAGC_TCGTGGATGGAGAGTC_CATTGTGTGTGACTAG	P
TCTAAGCGTATTGGTC_ATCCAGCGCTTGGACG_TCTCCGCTACGCGAGT_ATTGCCCGACTTTAGC_TCGTGGATGGAGAGTC_TGTGATCGTGACGTCG	P
TACAGGGGATGAAGCT_GTTGATTGGACGGATG_ATTACATATGCACGCC_ATTTCGGGGACGCGCC_TCTTTGGTAATCGAAA_TGTAGTGGTAAACCTC	P
TACAGGGGATGAAGCT_GTTGATTGGACGGATG_ATTACATATGCACGCC_ATTTCGGGGACGCGCC_TCTTTGGTAATCGAAA_TTTGCAGTGCCCGCAC	P
TACAGGGGATGAAGCT_GTTGATTGGACGGATG_ATTACATATGCACGCC_ATTTCGGGGACGCGCC_GGTGGACTGAACATAC_ACTTACCGGGGGAACA	P
TCTAAGCGTATTGGTC_ATCCAGCGCTTGGACG_AGATGAACCGGCCCAT_TCGGCTAAAGGTTGCG_TCGTACCGTGGCATTG_GGGACTAACAGGAGCT	P
GCATCGTACACCGGAT_GATCCACAGCCTGTAT_ATCAGTAAACTTTCAA_GTGGTAATCGCTCTGA_CAGTAACGATTTGGCA_GGCGTCCAAGATTGTG	P
GCATCGTACACCGGAT_GATCCACAGCCTGTAT_ATCAGTAAACTTTCAA_GTGGTAATCGCTCTGA_CAGTAACGATTTGGCA_CAACAACCCCAAATTC	P
GCATCGTACACCGGAT_GATCCACAGCCTGTAT_ATCAGTAAACTTTCAA_GTGGTAATCGCTCTGA_CAGTAACGATTTGGCA_CGTAGAACAACTCAGG	P
GCATCGTACACCGGAT_GATCCACAGCCTGTAT_ATCAGTAAACTTTCAA_GTGGTAATCGCTCTGA_CAGTAACGATTTGGCA_CAGGCGATATGAGCTA	P
GCATCGTACACCGGAT_GATCCACAGCCTGTAT_ATCAGTAAACTTTCAA_GTGGTAATCGCTCTGA_CAGTAACGATTTGGCA_AGAAAGATGGCTTCTA	P
GCATCGTACACCGGAT_GATCCACAGCCTGTAT_ATCAGTAAACTTTCAA_GTGGTAATCGCTCTGA_CAGTAACGATTTGGCA_CAAATTACTGAGCGTA	P
TACAGGGGATGAAGCT_GTTGATTGGACGGATG_ATTACATATGCACGCC_ATTTCGGGGACGCGCC_AGAGTCAGCTAGTATT_ACCAGCGTATAAGGTG	P
TACAGGGGATGAAGCT_GTTGATTGGACGGATG_ATTACATATGCACGCC_ATTTCGGGGACGCGCC_AGAGTCAGCTAGTATT_GCTCCTCAACTATACG	P
TCTAAGCGTATTGGTC_ATCCAGCGCTTGGACG_AGATGAACCGGCCCAT_TCTGGATGGGTACTTT_AGGCCAGATATTACGT_GCTCTAGGTTAGATCC	P
TACAGGGGATGAAGCT_GTTGATTGGACGGATG_ATTACATATGCACGCC_ATTTCGGGGACGCGCC_TGGTAACCGGGTCCTT_ATGGCGGCATGCCAGG	P
TACAGGGGATGAAGCT_GTTGATTGGACGGATG_ATTACATATGCACGCC_ATTTCGGGGACGCGCC_TGGTAACCGGGTCCTT_GACCATCTGAAACGTC	P
TACAGGGGATGAAGCT_GTTGATTGGACGGATG_ATTACATATGCACGCC_ATTTCGGGGACGCGCC_TTATAGCGGAGCGGGA_AAGGGCGATGTGTTGT	P
GCATCGTACACCGGAT_GATCCACAGCCTGTAT_ATCAGTAAACTTTCAA_GTGGTAATCGCTCTGA_TACAGGTCTGCGCATC_TGGCGTGAAAGATAGG	P
GCATCGTACACCGGAT_GATCCACAGCCTGTAT_ATCAGTAAACTTTCAA_GTGGTAATCGCTCTGA_TACAGGTCTGCGCATC_CTCAGAACCGCCATCT	P
GCATCGTACACCGGAT_GATCCACAGCCTGTAT_ATCAGTAAACTTTCAA_GTGGTAATCGCTCTGA_TACAGGTCTGCGCATC_TCGTGCTGAATGTCAT	P
TACAGGGGATGAAGCT_GTTGATTGGACGGATG_ATTACATATGCACGCC_ATTTCGGGGACGCGCC_CATATGACTAGACAGG_TTGATGTGACTTAACT	P
GCATCGTACACCGGAT_GATCCACAGCCTGTAT_ATCAGTAAACTTTCAA_GTGGTAATCGCTCTGA_TACGCGCAATTATCGA_ACATTTAGCCGTGCAG	P
GCATCGTACACCGGAT_GATCCACAGCCTGTAT_ATCAGTAAACTTTCAA_GTGGTAATCGCTCTGA_TACGCGCAATTATCGA_CCGAGTCAATCGAAAA	P
TAGTGACTTAGACCTG_CTTATCAACGGTGCTA_CAACCTGTAATTCTGC_GGCAGGTAGACCTTCA_GAGAAGAATGGAATGA_GCAATACGTCTTAAGT	A
TAGTGACTTAGACCTG_CTTATCAACGGTGCTA_TGCCTCGAAGGCCTAT_ATAGGGGTCGGACAAA_AGTACCACAGCGCAAG_TTCGCGCGCATCTCAG	P
TACAGGGGATGAAGCT_GTTGATTGGACGGATG_ATTACATATGCACGCC_ATTTCGGGGACGCGCC_CTGGGTTCACCTGTTG_TCTACCTTCAGATATT	P
ATAATGAGTGCACCTT_CAAGCATACTTATATG_CTGACAGCCGAGCCCT_GTAACGATAAAGAGCA_CTATTACGGCCACCCA_TCTAGTGCAGCGTTAG	P
TCTAAGCGTATTGGTC_ATCCAGCGCTTGGACG_AGATGAACCGGCCCAT_TACAAGCAGTAGGACA_AGTCGTCGTAGTCCGA_TGCCGTTACGCCGTAC	P
TACAGGGGATGAAGCT_GTTGATTGGACGGATG_ATTACATATGCACGCC_ATTTCGGGGACGCGCC_TAAGTACCTACACGTA_GCCTACGTGCCTATGC	P
TCTAAGCGTATTGGTC_ATCCAGCGCTTGGACG_AGATGAACCGGCCCAT_TCTGGATGGGTACTTT_ATCCACAAGAGGAATG_GTACACACCCATGAAC	P
TCTAAGCGTATTGGTC_ATCCAGCGCTTGGACG_AGATGAACCGGCCCAT_TCGGCTAAAGGTTGCG_GCAGCATCCACGAAGA_ACGCAGTACCAGGTCA	P
TACAGGGGATGAAGCT_GTTGATTGGACGGATG_ATTACATATGCACGCC_ATTTCGGGGACGCGCC_TTCAAGCCTTACGGAC_CTTGCCGATAGGCTTC	P
GCATCGTACACCGGAT_GATCCACAGCCTGTAT_ATCAGTAAACTTTCAA_GTGGTAATCGCTCTGA_GAAGACGGACACCTAG_ATGTTCGGGATGTATG	P
TCTAAGCGTATTGGTC_ATCCAGCGCTTGGACG_AGATGAACCGGCCCAT_AAATTGTTAGGGTGTC_GGGTACTGCAATAGGC_CATACGTCGCAAAAGT	P
TCTAAGCGTATTGGTC_ATCCAGCGCTTGGACG_AGATGAACCGGCCCAT_TGTGGATGCCCGCCCC_GCTTTCGCTAAACGAA_TAGCAGTGTCGGTTGA	P
TCTAAGCGTATTGGTC_ATCCAGCGCTTGGACG_TCTCCGCTACGCGAGT_ATTGCCCGACTTTAGC_AGGACCTTGTGTCTGT_GCACTGACGAAAAGTT	P
TACAGGGGATGAAGCT_GTTGATTGGACGGATG_ATTACATATGCACGCC_ATTTCGGGGACGCGCC_CCAAGCAAGGTGATAC_TTCCACGAGCGCTCTT	P
TACAGGGGATGAAGCT_GTTGATTGGACGGATG_ATTACATATGCACGCC_ATTTCGGGGACGCGCC_CCAAGCAAGGTGATAC_TAGGATGGTATGGGTC	P
TACAGGGGATGAAGCT_GTTGATTGGACGGATG_ATTACATATGCACGCC_ATTTCGGGGACGCGCC_CCAAGCAAGGTGATAC_TGTCCCTGTAACCGGA	P
GCATCGTACACCGGAT_GATCCACAGCCTGTAT_ATCAGTAAACTTTCAA_GTGGTAATCGCTCTGA_AACTGTCCCGATCCAG_GGTTGACCTCGCGCCG	P
TAGTGACTTAGACCTG_CTTATCAACGGTGCTA_AAGATTCAGCGTATAA_TACCGTCTGATCTGTA_TGCACAGCTCCCGGAC_TGGAACAAGAATTCGT	P
TCTAAGCGTATTGGTC_ATCCAGCGCTTGGACG_AGATGAACCGGCCCAT_TACAGGAGGACAGATC_TTTGCCGGCACCGACG_CTAACGCTGGATGTGG	P
TCTAAGCGTATTGGTC_ATCCAGCGCTTGGACG_TCTCCGCTACGCGAGT_ATTGCCCGACTTTAGC_TTGAATTCGCATTGGA_TCGAAGACTGGCTAAT	P
TCTAAGCGTATTGGTC_ATCCAGCGCTTGGACG_TCTCCGCTACGCGAGT_ATTGCCCGACTTTAGC_TTGAATTCGCATTGGA_ACCGAGTAGTTATGAA	P
TACAGGGGATGAAGCT_GTTGATTGGACGGATG_ATTACATATGCACGCC_ATTTCGGGGACGCGCC_TGGTATAGCTATGCAG_GTAATCGGCGCCCAGT	P
GCATCGTACACCGGAT_GATCCACAGCCTGTAT_ATCAGTAAACTTTCAA_GTGGTAATCGCTCTGA_GTACCTCTGACCCAAT_GACTTGAAAGAAATTG	P
GCATCGTACACCGGAT_GATCCACAGCCTGTAT_ATCAGTAAACTTTCAA_GTGGTAATCGCTCTGA_GTACCTCTGACCCAAT_ATTGGTGAGGAGGGCT	P
GCATCGTACACCGGAT_GATCCACAGCCTGTAT_ATCAGTAAACTTTCAA_GTGGTAATCGCTCTGA_GTACCTCTGACCCAAT_CCCCACAACCTGACCT	P
TACAGGGGATGAAGCT_GTTGATTGGACGGATG_ATTACATATGCACGCC_ATTTCGGGGACGCGCC_TAGAGACGCCCCCGAC_TGCAGTGACTCAGTTA	P
TCTAAGCGTATTGGTC_ATCCAGCGCTTGGACG_AGATGAACCGGCCCAT_AGTGCATACTTAGTAG_CATGAGCGTCGGACCG_GGATGAGCGCCGCTTG	P
TCTAAGCGTATTGGTC_ATCCAGCGCTTGGACG_AGATGAACCGGCCCAT_AGGACCCCTTGTCACA_TTCCTACTTTGTTATC_AATGATAAGGGCTCTG	P
TACAGGGGATGAAGCT_GTTGATTGGACGGATG_ATTACATATGCACGCC_ATTTCGGGGACGCGCC_CTTTTAGCGGCGGAGC_CTGGATTCTTCTCAGA	P
TACAGGGGATGAAGCT_GTTGATTGGACGGATG_ATTACATATGCACGCC_ATTTCGGGGACGCGCC_CTTTTAGCGGCGGAGC_CATAATACAAGGGGGC	P
TACAGGGGATGAAGCT_GTTGATTGGACGGATG_ATTACATATGCACGCC_ATTTCGGGGACGCGCC_AGATAAACTGATTGCT_ACCTCAATCATCCTCA	A
TACAGGGGATGAAGCT_GTTGATTGGACGGATG_ATTACATATGCACGCC_ATTTCGGGGACGCGCC_CCAAGAGTCCTGAGCC_TATTCTGACTCGAACA	P
TACAGGGGATGAAGCT_GTTGATTGGACGGATG_ATTACATATGCACGCC_ATTTCGGGGACGCGCC_TAGTCACCGCAGACCA_AATGAGTCCGGTAGAA	P
GCATCGTACACCGGAT_GATCCACAGCCTGTAT_ATCAGTAAACTTTCAA_GTGGTAATCGCTCTGA_CATCTCCCTCCGACTC_AACCCAAAGTTATCTA	P
TACAGGGGATGAAGCT_GTTGATTGGACGGATG_ATTACATATGCACGCC_ATTTCGGGGACGCGCC_ACGTATGTCCAGTACG_CTACTTCGCAGGGAGG	P
TACAGGGGATGAAGCT_GTTGATTGGACGGATG_ATTACATATGCACGCC_ATTTCGGGGACGCGCC_CTGTTCGCATCTTTCC_ATAAAACAGCGCAAGA	P
TACAGGGGATGAAGCT_GTTGATTGGACGGATG_ATTACATATGCACGCC_ATTTCGGGGACGCGCC_CTGTTCGCATCTTTCC_TAAGCTAACGTAAGTT	P
TACAGGGGATGAAGCT_GTTGATTGGACGGATG_ATTACATATGCACGCC_ATTTCGGGGACGCGCC_TATCGGCAGACAAGAA_TTCCCGGTCAACGCTC	P
TACAGGGGATGAAGCT_GTTGATTGGACGGATG_ATTACATATGCACGCC_ATTTCGGGGACGCGCC_TATCGGCAGACAAGAA_GGGAAAAACTACACGC	P
TCTAAGCGTATTGGTC_ATCCAGCGCTTGGACG_AGATGAACCGGCCCAT_GGTCTCCAAAAGCGGT_TGCAAGATCCTGGTTA_TAAATGTTGGCTGCTC	P
TCTAAGCGTATTGGTC_ATCCAGCGCTTGGACG_AGATGAACCGGCCCAT_GGTCTCCAAAAGCGGT_TGCAAGATCCTGGTTA_CGATATGCACGCGAAC	P
TACAGGGGATGAAGCT_GTTGATTGGACGGATG_ATTACATATGCACGCC_ATTTCGGGGACGCGCC_GGTAATCCGCTGATTA_GAATCAAAAACGGTAC	P
TACAGGGGATGAAGCT_GTTGATTGGACGGATG_ATTACATATGCACGCC_ATTTCGGGGACGCGCC_ACCTCTCGCATCCAAC_ACCAGAAATACATCTG	C
TACAGGGGATGAAGCT_GTTGATTGGACGGATG_ATTACATATGCACGCC_ATTTCGGGGACGCGCC_TCAGGGGAGGTTCGTC_CGGACCTAGGAGAACG	A
TCTAAGCGTATTGGTC_ATCCAGCGCTTGGACG_AGATGAACCGGCCCAT_TACAAGCAGTAGGACA_CATAGCACCACTGATA_CAGGAGGGTGATATTC	P
GCATCGTACACCGGAT_GATCCACAGCCTGTAT_ATCAGTAAACTTTCAA_GTGGTAATCGCTCTGA_CACAGCATTTTGGGAG_ACGCGGATACAAGATT	P
TCTAAGCGTATTGGTC_ATCCAGCGCTTGGACG_AGATGAACCGGCCCAT_TCTGGATGGGTACTTT_TTGGAGGAGTATCGTT_CGCTGGCTTAGCTGGT	P
TACAGGGGATGAAGCT_GTTGATTGGACGGATG_ATTACATATGCACGCC_ATTTCGGGGACGCGCC_TAGCGACGGTAATTCC_TGCGTGGCGAGCGCGT	P
GCATCGTACACCGGAT_GATCCACAGCCTGTAT_ATCAGTAAACTTTCAA_GTGGTAATCGCTCTGA_CATAAAGATTGTGAAG_AGAATTTAGTAGTGAT	P
GCATCGTACACCGGAT_GATCCACAGCCTGTAT_ATCAGTAAACTTTCAA_GTGGTAATCGCTCTGA_CATAAAGATTGTGAAG_TTACCGAGTAAACTTA	P
GCATCGTACACCGGAT_GATCCACAGCCTGTAT_ATCAGTAAACTTTCAA_GTGGTAATCGCTCTGA_CATAAAGATTGTGAAG_AAGCAACGCCATTGCA	P
GCATCGTACACCGGAT_GATCCACAGCCTGTAT_ATCAGTAAACTTTCAA_GTGGTAATCGCTCTGA_CATAAAGATTGTGAAG_GTGTCAGCCCGCACAG	P
GCATCGTACACCGGAT_GATCCACAGCCTGTAT_ATCAGTAAACTTTCAA_GTGGTAATCGCTCTGA_CATAAAGATTGTGAAG_CGCGTATTAAAAGTTC	P
TACAGGGGATGAAGCT_GTTGATTGGACGGATG_ATTACATATGCACGCC_ATTTCGGGGACGCGCC_TCGGCTACCCAGTCCC_CCCATGCTGACCGTTA	P
TACAGGGGATGAAGCT_GTTGATTGGACGGATG_ATTACATATGCACGCC_ATTTCGGGGACGCGCC_TCGGCTACCCAGTCCC_CCAAACGTTCTCAGAA	P
GCATCGTACACCGGAT_GATCCACAGCCTGTAT_ATCAGTAAACTTTCAA_GTGGTAATCGCTCTGA_AAACCAGGTGACGTTG_TCGCAATGGTACTACG	P
GCATCGTACACCGGAT_GATCCACAGCCTGTAT_ATCAGTAAACTTTCAA_GTGGTAATCGCTCTGA_AAACCAGGTGACGTTG_AACTAGCAAACGTCAA	P
TCTAAGCGTATTGGTC_ATCCAGCGCTTGGACG_TCTCCGCTACGCGAGT_ATTGCCCGACTTTAGC_GACCCATGCCGTGTTT_TATCGTGACTTTGGTT	P
TCTAAGCGTATTGGTC_ATCCAGCGCTTGGACG_TCTCCGCTACGCGAGT_ATTGCCCGACTTTAGC_GACCCATGCCGTGTTT_ATCTCGTCCACACCCA	P
TACAGGGGATGAAGCT_GTTGATTGGACGGATG_ATTACATATGCACGCC_ATTTCGGGGACGCGCC_GAGGTACGTAGGGTCT_CCGAACGCGATCGGTA	P
TAGTGACTTAGACCTG_CTTATCAACGGTGCTA_AAGATTCAGCGTATAA_TACCGTCTGATCTGTA_CTGAGTAAAAGGGACT_ATTCTAGGCTGTGGAA	P
GCATCGTACACCGGAT_GATCCACAGCCTGTAT_ATCAGTAAACTTTCAA_GTGGTAATCGCTCTGA_AGGAGACGTGAGATGT_TACCTAAGGTAAAATA	P
GCATCGTACACCGGAT_GATCCACAGCCTGTAT_ATCAGTAAACTTTCAA_GTGGTAATCGCTCTGA_AGGAGACGTGAGATGT_CCTACCGAGAATATCC	P
TACAGGGGATGAAGCT_GTTGATTGGACGGATG_ATTACATATGCACGCC_ATTTCGGGGACGCGCC_GAGCCAACTACGTACA_TACCTTCGAAGCGTCA	P
TACAGGGGATGAAGCT_GTTGATTGGACGGATG_ATTACATATGCACGCC_ATTTCGGGGACGCGCC_GAGCCAACTACGTACA_TTGAGACTTGGATCGC	P
TACAGGGGATGAAGCT_GTTGATTGGACGGATG_ATTACATATGCACGCC_ATTTCGGGGACGCGCC_GAGCCAACTACGTACA_CCTGCCCCGCAAAAGA	P
TACAGGGGATGAAGCT_GTTGATTGGACGGATG_ATTACATATGCACGCC_ATTTCGGGGACGCGCC_GAGCCAACTACGTACA_CGATTGTATTGCGCGC	P
TCTAAGCGTATTGGTC_ATCCAGCGCTTGGACG_TCTCCGCTACGCGAGT_ATTGCCCGACTTTAGC_AAGCCGAGGCTATTTC_GACTAGTGGTGTGTAG	C
TACAGGGGATGAAGCT_GTTGATTGGACGGATG_ATTACATATGCACGCC_ATTTCGGGGACGCGCC_TCTGCTAACGACGTCG_GCCCGGAGGTATATCC	P
TACAGGGGATGAAGCT_GTTGATTGGACGGATG_ATTACATATGCACGCC_ATTTCGGGGACGCGCC_CGACCCCGAGAGTGCG_GTATCGGCCAATCGTG	C;R(P)
GCATCGTACACCGGAT_GATCCACAGCCTGTAT_ATCAGTAAACTTTCAA_GTGGTAATCGCTCTGA_TGCCGCTTCCCCGCAC_CACATAAGCATGCAGA	P
TACAGGGGATGAAGCT_GTTGATTGGACGGATG_ATTACATATGCACGCC_ATTTCGGGGACGCGCC_AACTGGCCAAATGACC_ACTGCATAACTAATGG	P
TCTAAGCGTATTGGTC_ATCCAGCGCTTGGACG_AGATGAACCGGCCCAT_GGTCTCCAAAAGCGGT_TGGCGTCGGCGCAGCC_TTGGCCGCGGGCGCAA	C
