BC	flags
GCATCGTACACCGGAT_GATCCACAGCCTGTAT_ATCAGTAAACTTTCAA	C
TACTTTGCGTCGTCAA_GCTTCTGGGGAAGTAT_AAAAACCCACTTCTCC	B
ATAATGAGTGCACCTT_CAAGCATACTTATATG_ACGTCTTAAGCCGCAT	P;R(B+)
TAGTGACTTAGACCTG_CTTATCAACGGTGCTA_TGCCTCGAAGGCCTAT	C
TTTGGCAACCTGGGTG_TATTGCAGTTATGCAG_AGGCAAACCTCTCTGT	P
TTTGGCAACCTGGGTG_TATTGCAGTTATGCAG_TGTTAATCAGGGGGAG	A
TTTGGCAACCTGGGTG_TATTGCAGTTATGCAG_AAGTTAGTAAGTTAAT	P
TTTGGCAACCTGGGTG_TATTGCAGTTATGCAG_TCCGATGGCTTCGAGT	B
TTTGGCAACCTGGGTG_TATTGCAGTTATGCAG_AAGCGTTTGAAATGAT	P
TTTGGCAACCTGGGTG_TATTGCAGTTATGCAG_CAACCACCCGCATTCA	C
TTTGGCAACCTGGGTG_TATTGCAGTTATGCAG_TAAGACATGGCGCAGC	P
TTTGGCAACCTGGGTG_TATTGCAGTTATGCAG_TTCAGGTGGAAAATAT	P
TTTGGCAACCTGGGTG_TATTGCAGTTATGCAG_CTCAAGAATCGCGTAT	P
TTTGGCAACCTGGGTG_TATTGCAGTTATGCAG_TAGCAATAAACACGCT	P
TTTGGCAACCTGGGTG_TATTGCAGTTATGCAG_TGTCGGTAAATCTAGT	P
TACAGGGGATGAAGCT_GTTGATTGGACGGATG_GCTAATGCGATGTAAT	P;R(B)
TACAGGGGATGAAGCT_GTTGATTGGACGGATG_ATTACATATGCACGCC	C
ACGAGGCGTGTAATCA_GCGATGTCGCCCCACC_CTACCCTTTTGCTGCC	P
CCTGGAGCAGTCTAAT_CTGTGTCCAGCCTCGT_CCACTAATCGCCACAT	P
CCTGGAGCAGTCTAAT_CTGTGTCCAGCCTCGT_CTCCGCCGTCCGCATT	P
AGGGCGTCTCCAGAAT_CAGTGAGCGCCCGTCT_TTATAGTGAAAGAAGT	P;R(B)
ATCGTTGAATACACGC_CTTGCGCTCGAATGAT_ATAAGCGTGCGTCACT	P
ATCGTTGAATACACGC_CTTGCGCTCGAATGAT_AATTAGGGTTAGCCCC	P
GCATCGTACACCGGAT_GATCCACAGCCTGTAT_CCCGCGGTGGGCAACT	P
GCATCGTACACCGGAT_GATCCACAGCCTGTAT_TAAAAGTGGAAGGTTT	P
GCATCGTACACCGGAT_GATCCACAGCCTGTAT_TATGCGGTGCGGCACT	P
ATAGAATGGCTAAAAA_AGACCAGCTTATCAGT_CCAGCTCCCTTTCCGT	A
ACTGTACCTGCGGGTT_TGCGCCTTGTGATGTA_TTATCACCATACCTGC	P
ACTGTACCTGCGGGTT_TGCGCCTTGTGATGTA_TCCTGGGTGCTCAAGC	P
ACTGTACCTGCGGGTT_TGCGCCTTGTGATGTA_AAGAGCTTCGTTACGT	P
ACGCCACGCGTCTCAG_CAGGCGTCGTGGGTCA_AGATACCACGTCGCTG	A
TACTTTGCGTCGTCAA_GCTTCTGGGGAAGTAT_TGGCTCATGGATACAT	P
TACTTTGCGTCGTCAA_GCTTCTGGGGAAGTAT_ACGCGCAGACATATCT	P
TACTTTGCGTCGTCAA_GCTTCTGGGGAAGTAT_TAGAACTGAATCGGGG	P
TACTTTGCGTCGTCAA_GCTTCTGGGGAAGTAT_TGCACGTAGCATTAGT	P
TACTTTGCGTCGTCAA_GCTTCTGGGGAAGTAT_GGACCACTCAATGAGT	P
TACTTTGCGTCGTCAA_GCTTCTGGGGAAGTAT_GCCTTGTCGGGTCTTC	P
TACTTTGCGTCGTCAA_GCTTCTGGGGAAGTAT_TGAGACTAGGCCCGCA	P
TACTTTGCGTCGTCAA_GCTTCTGGGGAAGTAT_ATCGGCCCGTGTTACT	P
TACTTTGCGTCGTCAA_GCTTCTGGGGAAGTAT_AGAGACGCAACAATAT	P
TACTTTGCGTCGTCAA_GCTTCTGGGGAAGTAT_GCCGAAGTTTGAAAAT	P
TAGCACTCTGTGTCTA_CTCATGAGGACGAGGC_AGGAACTCATACGTGA	A
ATAATGAGTGCACCTT_CAAGCATACTTATATG_CTGACAGCCGAGCCCT	C
ATAATGAGTGCACCTT_CAAGCATACTTATATG_TCATTCAAGGTTCCAA	P
ATAATGAGTGCACCTT_CAAGCATACTTATATG_AGTGACCAAGGATCGG	P
CAGGACTAACTCTCCG_GCCTTCGGTCAAGCCA_GAAAGACGCAGGATGC	A
TAGTGACTTAGACCTG_CTTATCAACGGTGCTA_ACCGTCCGTGCGCTTT	P
TAGTGACTTAGACCTG_CTTATCAACGGTGCTA_CAACCTGTAATTCTGC	P;R(A)
TAGTGACTTAGACCTG_CTTATCAACGGTGCTA_AAGATTCAGCGTATAA	C
TAGTGACTTAGACCTG_CTTATCAACGGTGCTA_AAGGGTCCCCGAATTA	P
TAGTGACTTAGACCTG_CTTATCAACGGTGCTA_CCAGATGGAAATAAAC	P
TTTGGCAACCTGGGTG_TATTGCAGTTATGCAG_CGACTCGCTCGGGCCG	P
TTTGGCAACCTGGGTG_TATTGCAGTTATGCAG_AAATACTATACAACTC	P
TTTGGCAACCTGGGTG_TATTGCAGTTATGCAG_TAGCGAACCCCGAACA	P
TTTGGCAACCTGGGTG_TATTGCAGTTATGCAG_TAAGAGCTAACGTGCT	P
TTTGGCAACCTGGGTG_TATTGCAGTTATGCAG_CCACCAGTGTTACAGG	P
TTTGGCAACCTGGGTG_TATTGCAGTTATGCAG_ACTTGGCAGTGTGTCT	P
TTTGGCAACCTGGGTG_TATTGCAGTTATGCAG_TAGATGGCGGCTTTGA	P
TTTGGCAACCTGGGTG_TATTGCAGTTATGCAG_GCCACCTACGCCGTAC	P
TTTGGCAACCTGGGTG_TATTGCAGTTATGCAG_AATCAGCAGCCTCGAC	P
TTTGGCAACCTGGGTG_TATTGCAGTTATGCAG_TAAGTCAAGTGGCGGC	P
TTTGGCAACCTGGGTG_TATTGCAGTTATGCAG_AACTGTGAGAGACCGT	P
TTTGGCAACCTGGGTG_TATTGCAGTTATGCAG_AACACCGTAAAGTCTG	P
TTTGGCAACCTGGGTG_TATTGCAGTTATGCAG_CTCCACAAGTACTATT	P
TTTGGCAACCTGGGTG_TATTGCAGTTATGCAG_AACCAAGCCTATTGTA	P
TTTGGCAACCTGGGTG_TATTGCAGTTATGCAG_TCCGTCAGTCCAGCCT	P
TTTGGCAACCTGGGTG_TATTGCAGTTATGCAG_CCGGGGGCTGCGAATC	P
TTTGGCAACCTGGGTG_TATTGCAGTTATGCAG_AGAACGGTATCGTAAG	P
TTTGGCAACCTGGGTG_TATTGCAGTTATGCAG_TAACGTAAAGTTGGTC	P
TTTGGCAACCTGGGTG_TATTGCAGTTATGCAG_TCTGGCGTTCTGCCTA	P
TTTGGCAACCTGGGTG_TATTGCAGTTATGCAG_GCCGAAGTTTGAAAAT	P
TTTGGCAACCTGGGTG_TATTGCAGTTATGCAG_TCCCCCCCGACCACAA	P
TTTGGCAACCTGGGTG_TATTGCAGTTATGCAG_GTTACCTGTCGGTCAT	P
TTTGGCAACCTGGGTG_TATTGCAGTTATGCAG_CTCCAAACTGACGCCG	P
TTTGGCAACCTGGGTG_TATTGCAGTTATGCAG_GTTACCACAGAAATAT	P
TACGGAGCGAACAGTT_TCTTCCGAAGTTGGAC_TGGGTGCTGTCGCAGT	P
TACAGGGGATGAAGCT_GTTGATTGGACGGATG_CGCCACTCATGCACCA	P
TACAGGGGATGAAGCT_GTTGATTGGACGGATG_TAGCCGTAGGAAAAAC	P
TACAGGGGATGAAGCT_GTTGATTGGACGGATG_CAGCCCATACAAGAAT	P
TACAGGGGATGAAGCT_GTTGATTGGACGGATG_CGGTTTGGGCTCACCT	P
TACAGGGGATGAAGCT_GTTGATTGGACGGATG_CCAAAAATCGTCCCTT	P
TACAGGGGATGAAGCT_GTTGATTGGACGGATG_ATGTGTGCATAGAGTG	C
TACAGGGGATGAAGCT_GTTGATTGGACGGATG_TCTACAGCTGATCAGA	P
TACAGGGGATGAAGCT_GTTGATTGGACGGATG_GAGTATGTCCTGACTG	P
TGCTCCACACGAGTCC_CCTTTGGGGTGAGACC_TCTCCCGTCCAGATGT	P
TGCTCCACACGAGTCC_CCTTTGGGGTGAGACC_GCACGTTAGTGCTATC	P
TGCTCCACACGAGTCC_CCTTTGGGGTGAGACC_TTAGACGAGACTCAAT	P
ACTCGATCTCGCCGCC_CGGGGAAATTGCAAAC_AATCTGGGCCAAGTAT	P
TCTAAGCGTATTGGTC_ATCCAGCGCTTGGACG_GGCTAACAACATAAGT	P
TCTAAGCGTATTGGTC_ATCCAGCGCTTGGACG_GCAAGTGATGGTTGTT	P
TCTAAGCGTATTGGTC_ATCCAGCGCTTGGACG_TTTGCCCGGTCTCCCT	P
TCTAAGCGTATTGGTC_ATCCAGCGCTTGGACG_TTGCCGAAGAGAAGCT	P
TCTAAGCGTATTGGTC_ATCCAGCGCTTGGACG_GCGAATTTCAGACAGT	P
TCTAAGCGTATTGGTC_ATCCAGCGCTTGGACG_ATGGATTCCAGACCTA	P
TCTAAGCGTATTGGTC_ATCCAGCGCTTGGACG_AGATGAACCGGCCCAT	A
TCTAAGCGTATTGGTC_ATCCAGCGCTTGGACG_TCTCCGCTACGCGAGT	C
TCTAAGCGTATTGGTC_ATCCAGCGCTTGGACG_AAAGACGTGCTAAGAT	P
TCTAAGCGTATTGGTC_ATCCAGCGCTTGGACG_TAATTAGTACGCAACC	P
TCTAAGCGTATTGGTC_ATCCAGCGCTTGGACG_AGGAGCCGTTATATAT	P
AGCTATACCCCAACAA_CTGATTTCTGAGACTG_TACCTACAGACAATCT	A
AACCGCGATTGCATAG_GTTACAGTGGTCGTCG_TTTGAGTTAGGTGCGG	A
TACCTAGTTTACAGAC_AAAGATAGGGTCTCTA_ACCGATCAGCGTTCTC	P
CATCCGTTCCTGTAGA_AGGTCGAATCCCTCTT_TGCTCGAGTCCTGGGA	P
CATCCGTTCCTGTAGA_AGGTCGAATCCCTCTT_ACGTACTTGTTAAAGC	P
CATCCGTTCCTGTAGA_AGGTCGAATCCCTCTT_CATTCGCATCTGGGAG	P
CATCCGTTCCTGTAGA_AGGTCGAATCCCTCTT_CTGCGGTTCAGGAGAT	P
CATCCGTTCCTGTAGA_AGGTCGAATCCCTCTT_AAACGCTGCATCCGCA	P
CATCCGTTCCTGTAGA_AGGTCGAATCCCTCTT_GTCGGATGTTCCAGTC	P
GGCGAGAACTTAATGG_GTGCTCGCAACTTTAC_CATTTATGGGCAGTCG	P
