BC	flags
CCTGGAGCAGTCTAAT	A;R(C)
ACGAGGCGTGTAATCA	B
GCATCGTACACCGGAT	C
CATCCGTTCCTGTAGA	C
TGCTCCACACGAGTCC	C
TACAGGGGATGAAGCT	C
TTTGGCAACCTGGGTG	C
GTGCCTAGACCAACTT	B
ATAATGAGTGCACCTT	C
TCATCCGTAGGAACGT	N;R(A)
ATAGAATGGCTAAAAA	C
TCTAAGCGTATTGGTC	C
GCATAGGGGGGAGCAC	C;R(N)
TAGTGACTTAGACCTG	C
ATCGTTGAATACACGC	C
GCCGGCCCTATACGAA	C
TACCTAGTTTACAGAC	C
GCCGTGCCAAAGTAGG	C
GGTGGCCTCATAGTAC	C
AGGGCGTCTCCAGAAT	C
AATAGTTCTGGGGACC	C
AGACCTATATCGCAAT	C
GGGGAAGTGTCCGGCA	C
ACTGTACCTGCGGGTT	C
TACTTTGCGTCGTCAA	C
GTCTTGGCTCCGATTG	C
TAGCACTCTGTGTCTA	C
ACGCCACGCGTCTCAG	C
AGCTATACCCCAACAA	A
GGCGAGAACTTAATGG	C
ATGGGGATGGCTGGCC	C
ACTCGATCTCGCCGCC	C
CAGGACTAACTCTCCG	C
TACGGAGCGAACAGTT	C
