BC	flags
TTTGGCAACCTGGGTG_TATTGCAGTTATGCAG_CAACCACCCGCATTCA_TGAGGGAACCCCTTGA_ACGGTTATGTAACCGG_CCTGCCCCAGTAACCT_AAAATTCATATGGGCA_ATGTGGGCAGCCGGCT	P;R(B)
TTTGGCAACCTGGGTG_TATTGCAGTTATGCAG_CAACCACCCGCATTCA_TGAGGGAACCCCTTGA_ACGGTTATGTAACCGG_CCTGCCCCAGTAACCT_ACTCGACTACAACCGC_GTGTGGGTATCGGCCG	P
TTTGGCAACCTGGGTG_TATTGCAGTTATGCAG_CAACCACCCGCATTCA_TGAGGGAACCCCTTGA_ACGGTTATGTAACCGG_CCTGCCCCAGTAACCT_CTGCCCCACCCAGTCT_GCTAAGTATGTAAGGC	P
TACAGGGGATGAAGCT_GTTGATTGGACGGATG_ATTACATATGCACGCC_ATTTCGGGGACGCGCC_CTAGCTATGTTCACCC_CGGCCAACCTTCTGGA_AAAAGGCTCGTGGTGC_TTGACGGGGTATGAAA	B
TTTGGCAACCTGGGTG_TATTGCAGTTATGCAG_CAACCACCCGCATTCA_TGAGGGAACCCCTTGA_ACGGTTATGTAACCGG_CCTGCCCCAGTAACCT_AACCCTGTATCAAACT_AGGCACACTCGTCATC	P
TTTGGCAACCTGGGTG_TATTGCAGTTATGCAG_CAACCACCCGCATTCA_TGAGGGAACCCCTTGA_ACGGTTATGTAACCGG_CCTGCCCCAGTAACCT_TATAGGGTTGGGGAGG_TTCCGTATCCGAGACT	P
GCATCGTACACCGGAT_GATCCACAGCCTGTAT_ATCAGTAAACTTTCAA_GTGGTAATCGCTCTGA_CAGTAACGATTTGGCA_CAAATTACTGAGCGTA_TCTGGCGGGAATGTAA_CTGGGCTAAAATGGAG	P
TTTGGCAACCTGGGTG_TATTGCAGTTATGCAG_CAACCACCCGCATTCA_TGAGGGAACCCCTTGA_ACGGTTATGTAACCGG_CCTGCCCCAGTAACCT_TCCCATAATGAACAGC_GCGAGCTCTCCATCGT	P
TTTGGCAACCTGGGTG_TATTGCAGTTATGCAG_CAACCACCCGCATTCA_TGAGGGAACCCCTTGA_ACGGTTATGTAACCGG_CCTGCCCCAGTAACCT_TCCCATAATGAACAGC_TTCAGGGCATTAAGTA	P
TTTGGCAACCTGGGTG_TATTGCAGTTATGCAG_CAACCACCCGCATTCA_TGAGGGAACCCCTTGA_ACGGTTATGTAACCGG_CCTGCCCCAGTAACCT_TCCCATAATGAACAGC_TACGAAATACAAGTAA	P
TACAGGGGATGAAGCT_GTTGATTGGACGGATG_ATTACATATGCACGCC_ATTTCGGGGACGCGCC_AGATAAACTGATTGCT_ACCTCAATCATCCTCA_GTTGTAGTTACGTTGA_CTGTTCGTTCTTCCCA	P
TACAGGGGATGAAGCT_GTTGATTGGACGGATG_ATTACATATGCACGCC_ATTTCGGGGACGCGCC_AGATAAACTGATTGCT_ACCTCAATCATCCTCA_GTTGTAGTTACGTTGA_GGGCTTGAGTCAGATG	P
TACAGGGGATGAAGCT_GTTGATTGGACGGATG_ATTACATATGCACGCC_ATTTCGGGGACGCGCC_AGATAAACTGATTGCT_ACCTCAATCATCCTCA_GTTGTAGTTACGTTGA_ACAACAAATGCAATGT	P
TACAGGGGATGAAGCT_GTTGATTGGACGGATG_ATTACATATGCACGCC_ATTTCGGGGACGCGCC_AGATAAACTGATTGCT_ACCTCAATCATCCTCA_GTTGTAGTTACGTTGA_CAAGTACCTCCCAAGC	P
TACAGGGGATGAAGCT_GTTGATTGGACGGATG_ATTACATATGCACGCC_ATTTCGGGGACGCGCC_TGGTAACCGGGTCCTT_TCCGCCAGTGTACTTA_CTTCTGTCGCCACCCG_AAGCGCCGTCACAGAC	P
TACAGGGGATGAAGCT_GTTGATTGGACGGATG_ATTACATATGCACGCC_ATTTCGGGGACGCGCC_TGGTAACCGGGTCCTT_TCCGCCAGTGTACTTA_TCCGGTGTCCGGAACA_TCTCGATTAAACTGCA	P
TCTAAGCGTATTGGTC_ATCCAGCGCTTGGACG_TCTCCGCTACGCGAGT_ATTGCCCGACTTTAGC_AAGCCGAGGCTATTTC_GACTAGTGGTGTGTAG_CAAAGATTATATGTGC_CACGTGGCGCTGCACG	P
GCATCGTACACCGGAT_GATCCACAGCCTGTAT_ATCAGTAAACTTTCAA_GTGGTAATCGCTCTGA_CAGTAACGATTTGGCA_CGTAGAACAACTCAGG_CTGTTGTGTGTCCGCT_CTCCAGTAGTGTAGAA	P
TACAGGGGATGAAGCT_GTTGATTGGACGGATG_ATTACATATGCACGCC_ATTTCGGGGACGCGCC_ACCTCTCGCATCCAAC_ACCAGAAATACATCTG_ACTGCGGTAACTTGTT_AAGAGGCTTGCTGGGG	A
TACAGGGGATGAAGCT_GTTGATTGGACGGATG_ATTACATATGCACGCC_ATTTCGGGGACGCGCC_AGATAAACTGATTGCT_ACCTCAATCATCCTCA_CAGTCTGAAGTAAACG_TCGGGTTTTAGCACGG	P
TACAGGGGATGAAGCT_GTTGATTGGACGGATG_ATTACATATGCACGCC_ATTTCGGGGACGCGCC_AGATAAACTGATTGCT_ACCTCAATCATCCTCA_GTGGTCATATTGTCAA_CGGCTCTCGCTTTCAG	P
TTTGGCAACCTGGGTG_TATTGCAGTTATGCAG_CAACCACCCGCATTCA_TGAGGGAACCCCTTGA_ACGGTTATGTAACCGG_CCTGCCCCAGTAACCT_ACTCGACTACAACCGC_CCGGTGCTAGTAGTTT	P
TTTGGCAACCTGGGTG_TATTGCAGTTATGCAG_CAACCACCCGCATTCA_TGAGGGAACCCCTTGA_ACGGTTATGTAACCGG_CCTGCCCCAGTAACCT_ACTCGACTACAACCGC_TGCTTGATTGGGTTGG	P
TACAGGGGATGAAGCT_GTTGATTGGACGGATG_ATTACATATGCACGCC_ATTTCGGGGACGCGCC_CGACCCCGAGAGTGCG_GTATCGGCCAATCGTG_GACATGCATACACGGA_TGACGCCCTACGGGGC	P;R(A)
GCATCGTACACCGGAT_GATCCACAGCCTGTAT_ATCAGTAAACTTTCAA_GTGGTAATCGCTCTGA_CAGTAACGATTTGGCA_CAAATTACTGAGCGTA_ACGCCTTTGGGCAGAA_CCTGGCTTGGGATGTA	P
GCATCGTACACCGGAT_GATCCACAGCCTGTAT_ATCAGTAAACTTTCAA_GTGGTAATCGCTCTGA_TGCCGCTTCCCCGCAC_TCCCCTCGCATACGAC_TGAGAATACAAGCCCA_AGGTGCGGGGTACGAT	P
TCTAAGCGTATTGGTC_ATCCAGCGCTTGGACG_AGATGAACCGGCCCAT_GGTCTCCAAAAGCGGT_TGGCGTCGGCGCAGCC_TTGGCCGCGGGCGCAA_TTAAAAGACATCGGTA_CATTGCTGGCTTAACA	P
TACAGGGGATGAAGCT_GTTGATTGGACGGATG_ATTACATATGCACGCC_ATTTCGGGGACGCGCC_TGGTAACCGGGTCCTT_TCCGCCAGTGTACTTA_CCCAAGGGTAAGGTCG_GTCAGAAAGACAGCAT	P
TACAGGGGATGAAGCT_GTTGATTGGACGGATG_ATTACATATGCACGCC_ATTTCGGGGACGCGCC_TGGTAACCGGGTCCTT_TCCGCCAGTGTACTTA_CCAGGATACCGCAGTT_AAACCACTCGCCACGG	P
TACAGGGGATGAAGCT_GTTGATTGGACGGATG_ATTACATATGCACGCC_ATTTCGGGGACGCGCC_TGGTAACCGGGTCCTT_TCCGCCAGTGTACTTA_CCAGGATACCGCAGTT_GCTCTGCCTGCTAGTA	P
TCTAAGCGTATTGGTC_ATCCAGCGCTTGGACG_TCTCCGCTACGCGAGT_ATTGCCCGACTTTAGC_AAGCCGAGGCTATTTC_GACTAGTGGTGTGTAG_CTGGGGATTGTGGTAT_TCCACAGGGTCTATTC	P
TCTAAGCGTATTGGTC_ATCCAGCGCTTGGACG_TCTCCGCTACGCGAGT_ATTGCCCGACTTTAGC_AAGCCGAGGCTATTTC_GACTAGTGGTGTGTAG_CTGGGGATTGTGGTAT_TCAATTGAGCTATGGT	P
TCTAAGCGTATTGGTC_ATCCAGCGCTTGGACG_TCTCCGCTACGCGAGT_ATTGCCCGACTTTAGC_AAGCCGAGGCTATTTC_GACTAGTGGTGTGTAG_CTGGGGATTGTGGTAT_GTATCAAGACGTCCGT	P
TCTAAGCGTATTGGTC_ATCCAGCGCTTGGACG_TCTCCGCTACGCGAGT_ATTGCCCGACTTTAGC_AAGCCGAGGCTATTTC_GACTAGTGGTGTGTAG_CTGGGGATTGTGGTAT_GGTTGATCTCTACCGG	P
TCTAAGCGTATTGGTC_ATCCAGCGCTTGGACG_TCTCCGCTACGCGAGT_ATTGCCCGACTTTAGC_AAGCCGAGGCTATTTC_GACTAGTGGTGTGTAG_CTGGGGATTGTGGTAT_ATCGGGTCACTAACTT	P
TCTAAGCGTATTGGTC_ATCCAGCGCTTGGACG_TCTCCGCTACGCGAGT_ATTGCCCGACTTTAGC_AAGCCGAGGCTATTTC_GACTAGTGGTGTGTAG_CTGGGGATTGTGGTAT_GCTTGCAGGACAGCTC	P
TCTAAGCGTATTGGTC_ATCCAGCGCTTGGACG_TCTCCGCTACGCGAGT_ATTGCCCGACTTTAGC_AAGCCGAGGCTATTTC_GACTAGTGGTGTGTAG_CTGGGGATTGTGGTAT_CGAAAAAAGTCAGCCC	P
GCATCGTACACCGGAT_GATCCACAGCCTGTAT_ATCAGTAAACTTTCAA_GTGGTAATCGCTCTGA_GTACCTCTGACCCAAT_ATTGGTGAGGAGGGCT_TTTCAGTTGGTCTAAA_ACATCTACTTCGAATC	P
TACAGGGGATGAAGCT_GTTGATTGGACGGATG_ATTACATATGCACGCC_ATTTCGGGGACGCGCC_CTTTTAGCGGCGGAGC_CTGGATTCTTCTCAGA_GTTGCATTGATTAAGC_TGGTTGTGAGCCCAGG	P
GCATCGTACACCGGAT_GATCCACAGCCTGTAT_ATCAGTAAACTTTCAA_GTGGTAATCGCTCTGA_CAGTAACGATTTGGCA_CGTAGAACAACTCAGG_CAGCTATAGGGTTCGT_GCAACGGACTCGCTTT	P
TACAGGGGATGAAGCT_GTTGATTGGACGGATG_ATTACATATGCACGCC_ATTTCGGGGACGCGCC_TCAGGGGAGGTTCGTC_CGGACCTAGGAGAACG_TGGGGGTATGAATTCG_GCTTGTAATACGTGAG	A
ATAATGAGTGCACCTT_CAAGCATACTTATATG_CTGACAGCCGAGCCCT_TTCCTGAGAAGATTGC_GACCCTCAACACATCG_GGGTCCAAAGGTAAAC_ATACATTACAAATTGG_TTCGGAGACTATCGCA	P
ATAATGAGTGCACCTT_CAAGCATACTTATATG_CTGACAGCCGAGCCCT_TTCCTGAGAAGATTGC_GACCCTCAACACATCG_GGGTCCAAAGGTAAAC_AAGGATTCTATGCGTT_ACTTCAATTGCGCCTC	P
ATAATGAGTGCACCTT_CAAGCATACTTATATG_CTGACAGCCGAGCCCT_TTCCTGAGAAGATTGC_GACCCTCAACACATCG_GGGTCCAAAGGTAAAC_ACACATTGGGCAGCCC_CAACGATATGCTGCAT	P
TTTGGCAACCTGGGTG_TATTGCAGTTATGCAG_CAACCACCCGCATTCA_TGAGGGAACCCCTTGA_ACGGTTATGTAACCGG_CCTGCCCCAGTAACCT_AACCCTGTATCAAACT_CTCTTGAACCGGTATA	P
TACAGGGGATGAAGCT_GTTGATTGGACGGATG_ATTACATATGCACGCC_ATTTCGGGGACGCGCC_TGGTAACCGGGTCCTT_TCCGCCAGTGTACTTA_TAGTGAGGCCTGTGGA_ATTTGGACGTCTGTTC	P
TACAGGGGATGAAGCT_GTTGATTGGACGGATG_ATTACATATGCACGCC_ATTTCGGGGACGCGCC_AGATAAACTGATTGCT_ACCTCAATCATCCTCA_ATGTGAAGGTAAGAAA_GTGAGGACATCGCTTC	P
TACAGGGGATGAAGCT_GTTGATTGGACGGATG_ATTACATATGCACGCC_ATTTCGGGGACGCGCC_AGATAAACTGATTGCT_ACCTCAATCATCCTCA_ATGTGAAGGTAAGAAA_CACTGCCCGAATGGCA	P
TACAGGGGATGAAGCT_GTTGATTGGACGGATG_ATTACATATGCACGCC_ATTTCGGGGACGCGCC_GAGCCAACTACGTACA_TACCTTCGAAGCGTCA_GGATTGATTAGTTAGG_TCCCTATTCACGGGTA	P
TACAGGGGATGAAGCT_GTTGATTGGACGGATG_ATTACATATGCACGCC_ATTTCGGGGACGCGCC_AGATAAACTGATTGCT_ACCTCAATCATCCTCA_TGAATTCGTGCAGACC_GTCGGTTCGGTGGCCA	P
