BC	flags
TCGAAGCCAGCGGGTA_CATAAGCGGCGGCGAG	N;R(B)
AGTAAGACCTCGGGCC_CGCGCTTGGTTGGCTC	P
AGTAAGACCTCGGGCC_TCCCTGAAGGCACATC	P
CGCGGTGGAACGGAGG_CGCAACATGTAAACTT	A
CTAGAGACACGTCTAC_ATGGTATATCAATGGC	C
ACAATCCGAATGAAGG_CTTGGAACTGCGTTGA	A
CGAAGCGATGCGTGTA_CGTGTAACCCTCGCAA	A
TGCGGCATAGTCCTCG_GTAGGTTATGCGGAAG	A
CGGCCGGGCGCCCTTA_CCGTCGCTTTGGTCCG	N;R(B)
CGTATGAAACCTGGGG_GGCAGGTTTTGCGCGA	C
GTGCGGACCCCGTGAT_ATCCAAAATCTGTGAC	A
TCCATTGAGAACAACT_TGCACACCCATGAGTA	C
TCCATTGAGAACAACT_ACCTAGGTCGTGGGAG	C
CCACGCGCGGTACGTC_TGCCACACACGACGAT	C
CCGAGTCTTCCAACTT_GAAACGTCTCCCACCC	B
TCGACTTGGTTCAAGG_GTCGGCGAGCCAAGGA	B
GCAACCCTGCAACTTC_CAAGGAGGGTACTTCG	C
CCCGCAGAAAAGTAGC_CGCACCGAATTCCATC	B
CCTTGACCTCCGACTA_AAATCTTCCTACGCAA	A
GTTTAATTTAATCGTG_TCCACTGCTTTAAGTG	C
TGACGGGGCCCCGGTA_CAGGGTGAAGCGCTCG	B
TAGGTCAAATGCGCGA_ACGCCTCGAATGTGTG	N;R(B)
ACCCAACAGGTTCAAT_ACCAGAGGAGCGTATT	A
TGCTAAAAAGATCTAG_TGTGTTCAGGGGGCTG	A
GAAGCGGTACGGGATT_ACGGCGAGGCGCAGAG	B;R(P)
TACCCGATGGCGAAGC_GTTCCAGTCCTTATCA	P
ACTTCGGGTGTCGTAG_GAACAGTCGAAGAGTA	C
GAATAACGCTTCTTGT_AAAGCATCCACGCGGG	A
TTGACAACTCCGCCGT_GAAGCCTAATACATAA	P
AACGAGGCAGCGTTTT_CTCCTGGACACGTCTG	A
GAGAAAACCTAGTGTG_AGCTACCAATTAAGCA	A
GAAAAGAGTGACGTTT_CATTGGCTCACACAAG	A
AACTTGAATAACCATG_GTATTAGGGGCACAAT	A;R(P)
TCTAGCGCGGCCGAAT_CGTTGCCTCCCCACCG	P
TCTAGCGCGGCCGAAT_TCGTAATATCGCACAT	P
TCTAGCGCGGCCGAAT_CTATGAGGTAGAAACA	A
TCCATTGAGAACAACT_ACCGTCTAAAGCGTGC	P
CCACGCGCGGTACGTC_GGTATGTTAACGGAGA	P
AACCGATGTTGCCCAA_TTCTCGAAGCACGTAG	A
GTTAACGGCCAGTCAC_CCGTGTACACGGCCAT	A
GCAACCCTGCAACTTC_CATACGGCAGTCAGTA	P
GCAACCCTGCAACTTC_TCGGCGATGGTCGAAG	P
GCAACCCTGCAACTTC_TCTGGACAACGAGCGC	P
TAAGGTTCAAAACTCC_TAGACCTTGCCAACAT	C
TAAGGTTCAAAACTCC_GGACGTTGTGTTCTGT	P
AAGTAAGCCACTCACC_CCCAGGTTAAGGCAAA	P
TCAGGCCACGTAAGAG_CTGCGAATACGGTGTG	A
GTTTGGCAAGACAGCA_TGGAGAGGGACTGAGT	A
TTGCAGGGCAAGGCGC_ACGGACACCACTATAT	C
TAAATCTTGTCAGTCA_TCTGGACCCGGTAGAG	C
TAGTGGCCTCCCAGAA_CCTCTATCAATAGTTA	A
TTATAAACACCCTTCC_CCTGGCGTGTCGAATC	C
TCTGAGCCATAAATAA_TAAGCAGCCACTGATC	A
GTACCAAAGAGAGCAG_CGGGAGCGCTTGGGTT	A
TTGTCCGTCTTCGAAC_CGCCCTTTGGTGAACG	P
TTGTCCGTCTTCGAAC_CGGACATCCAAGTGTC	P
CAATGGTCTGATCTAT_CAGTATTGTGACGCAT	A
TTGTCATCAGCGGTAA_CACGACTGGCACTTTT	A
