BC	flags
AGTAAGACCTCGGGCC	A
GTGCGGACCCCGTGAT	C
CCACGCGCGGTACGTC	A
AGATGAGATCCGCGTA	N;R(B)
AAACTTATGCACTCAC	B
TACCCGATGGCGAAGC	B;R(C)
CGAAGCGATGCGTGTA	C
CGTATGAAACCTGGGG	C
TCCATTGAGAACAACT	A
CGCGGTGGAACGGAGG	C
GCGTACAGTGGACCTT	B
TGACGGGGCCCCGGTA	C
CTAGAGACACGTCTAC	C
ACAATCCGAATGAAGG	C
GCAACCCTGCAACTTC	A
CCTTGACCTCCGACTA	C
GAAGCGGTACGGGATT	C;R(B)
CTCTCTGGACGTAAGT	N;R(B)
TGCGGCATAGTCCTCG	C
GGAGTTAAACGAAGGT	N;R(B)
CCGAGTCTTCCAACTT	C
CCCGCAGAAAAGTAGC	C
GTTTAATTTAATCGTG	C
ACCCAACAGGTTCAAT	C
TGCTAAAAAGATCTAG	C
ACTTCGGGTGTCGTAG	C
GAAAAGAGTGACGTTT	C
TCTAGCGCGGCCGAAT	A
AACCGATGTTGCCCAA	C
TAAGGTTCAAAACTCC	A
TTGTCCGTCTTCGAAC	A
TTGACAACTCCGCCGT	A
GTTAACGGCCAGTCAC	C
CAATGGTCTGATCTAT	C
TTGTCATCAGCGGTAA	C
AACGAGGCAGCGTTTT	C
AACTTGAATAACCATG	C;R(A)
TAGTGGCCTCCCAGAA	C
AAGTAAGCCACTCACC	A
TAAATCTTGTCAGTCA	C
GAATAACGCTTCTTGT	C
GAGAAAACCTAGTGTG	C
TCAGGCCACGTAAGAG	C
GTTTGGCAAGACAGCA	C
TTATAAACACCCTTCC	C
TCTGAGCCATAAATAA	C
GTACCAAAGAGAGCAG	C
