BC	flags
TGCTAAAAAGATCTAG_TGTGTTCAGGGGGCTG_TAAGCTTAACGAGCCG_ATCCAACTTGAGGATA	P
TCTAGCGCGGCCGAAT_CTATGAGGTAGAAACA_TAAGTGCGTAAGTGAG_TCCAGAGCAAATGTAT	P
CGCGGTGGAACGGAGG_CGCAACATGTAAACTT_TGTACCGCAATTATAC_TATCGAGTAAGCACAT	P
CGCGGTGGAACGGAGG_CGCAACATGTAAACTT_TGTACCGCAATTATAC_GTTGTGTGCGCTCTCC	C
TCCATTGAGAACAACT_ACCTAGGTCGTGGGAG_TTGTCCCTAGTTGTGT_AGCCAAAAAAGTTGAC	P
TCCATTGAGAACAACT_ACCTAGGTCGTGGGAG_TTGTCCCTAGTTGTGT_CATGGTTAAGGACTGT	P
CGCGGTGGAACGGAGG_CGCAACATGTAAACTT_ATGGGATTCAGTTGCC_AATGTGCACTCCAAGG	P
TCTAGCGCGGCCGAAT_CTATGAGGTAGAAACA_CCGGAAAGAGTACGAC_CGGAATCATTATCGTC	P
TCTAGCGCGGCCGAAT_CTATGAGGTAGAAACA_CCGGAAAGAGTACGAC_CCAACGAAGTGATTCT	C
TGCTAAAAAGATCTAG_TGTGTTCAGGGGGCTG_TTATCGGACAGCGTGC_CCAGCTGGTCCGCCAG	C
CGCGGTGGAACGGAGG_CGCAACATGTAAACTT_AAAAAACTCGCGGGGT_TCGCTATACTGCAAGT	P
CGCGGTGGAACGGAGG_CGCAACATGTAAACTT_AAAAAACTCGCGGGGT_TGCAGCTATCGCTTGC	P
ACTTCGGGTGTCGTAG_GAACAGTCGAAGAGTA_TGGACATAATGATAGT_ACGGGCTTATCCGGAC	A
CGCGGTGGAACGGAGG_CGCAACATGTAAACTT_AGAATTACCTCTGCAA_ACGGGGTGCGATCAGG	P
CGAAGCGATGCGTGTA_CGTGTAACCCTCGCAA_TCTGTGAGATGGAGTC_CGGAAGCGTTTACCTA	C
CGAAGCGATGCGTGTA_CGTGTAACCCTCGCAA_TCTGTGAGATGGAGTC_AAGACTACACACGCTC	C
CGCGGTGGAACGGAGG_CGCAACATGTAAACTT_GGCCCATAGGTCATCT_GACGGGATGCTGGTAA	C
TCCATTGAGAACAACT_TGCACACCCATGAGTA_GGTTGCAAGCATAGAA_GCTGTCGCGTTTCGTT	C
CCTTGACCTCCGACTA_AAATCTTCCTACGCAA_CAAGCCACGGTTAGGT_AACTTAGCGGGGATAA	P
TGCTAAAAAGATCTAG_TGTGTTCAGGGGGCTG_TAGAACCCGAGAGGGT_ATAGGAAGGTACGTCG	P
TGCTAAAAAGATCTAG_TGTGTTCAGGGGGCTG_TAGAACCCGAGAGGGT_AGTCGGATGTACTCCC	P
CGCGGTGGAACGGAGG_CGCAACATGTAAACTT_ACGGTCGGTCAGGTTT_TCAGGCAACAGGGAGT	C;R(P)
GTGCGGACCCCGTGAT_ATCCAAAATCTGTGAC_TAGATTCATAGCTGGC_TAACGGCTCCGGCGGT	P;R(B)
GTGCGGACCCCGTGAT_ATCCAAAATCTGTGAC_TAGATTCATAGCTGGC_TTGATTCCTGTTTTGT	P
CGCGGTGGAACGGAGG_CGCAACATGTAAACTT_AACGATGATACGTGGT_AGTATTATGCGACGCC	A
CGCGGTGGAACGGAGG_CGCAACATGTAAACTT_ACTGAGTAGGACTCAT_ACAGCACCCATGTCAC	P
CGCGGTGGAACGGAGG_CGCAACATGTAAACTT_ACTGAGTAGGACTCAT_TGGTTTGGGGTGAGAG	P
CGCGGTGGAACGGAGG_CGCAACATGTAAACTT_ACTGAGTAGGACTCAT_TTAGAGAATGTCGACG	P
CGCGGTGGAACGGAGG_CGCAACATGTAAACTT_TAATTTGGGTACACGT_AATGAGAGCCACCCAG	P
TGCTAAAAAGATCTAG_TGTGTTCAGGGGGCTG_TATCAGCCGGTTAAAT_AAAGGAACGGGATTGG	P
CGCGGTGGAACGGAGG_CGCAACATGTAAACTT_GCTTAGATGTTGGAGT_TTCAGGGCGGGATATT	P;R(A)
GCAACCCTGCAACTTC_CAAGGAGGGTACTTCG_ACAGCGATGTCCATCC_GCTGGCAAGAAAACGA	P
ACCCCAGAAAGACGCG_CGATCCGAACTACCTA_ACCCCTTATCGAGCGG_CCGTCAGCCCACAAGG	B
GTTTAATTTAATCGTG_TCCACTGCTTTAAGTG_TAACGAACACGTACGC_TAGCCTGAGACTGTAT	C
CGCGGTGGAACGGAGG_CGCAACATGTAAACTT_TCATTAGAGTAGGTGT_GGGACGACGAACATTG	P
CGCGGTGGAACGGAGG_CGCAACATGTAAACTT_TCATTAGAGTAGGTGT_AACTAACGTGCTGTTG	P
CGCGGTGGAACGGAGG_CGCAACATGTAAACTT_TCATTAGAGTAGGTGT_GGTAGTTCAAATGTCA	P;R(C+)
CGCGGTGGAACGGAGG_CGCAACATGTAAACTT_AATCTCATAGCCCGAA_AAACAGCGCCGCTCTT	P
TGCTAAAAAGATCTAG_TGTGTTCAGGGGGCTG_TGGCGGCATTTCGCGG_TTGATGGTGTACCTTC	P
TGCTAAAAAGATCTAG_TGTGTTCAGGGGGCTG_TGGCGGCATTTCGCGG_GGCCGAGTGAATTCCA	P
TGCTAAAAAGATCTAG_TGTGTTCAGGGGGCTG_TGGCGGCATTTCGCGG_ACAGCAGATTAAGAAT	P
CCACGCGCGGTACGTC_TGCCACACACGACGAT_TATGTAGATCCAATGG_GCGCTACGCATTGAAG	P
CCACGCGCGGTACGTC_TGCCACACACGACGAT_TATGTAGATCCAATGG_CCGTCGAACGCGTAAT	P
CCACGCGCGGTACGTC_TGCCACACACGACGAT_TATGTAGATCCAATGG_AGACACATGACATCCA	C
CCACGCGCGGTACGTC_TGCCACACACGACGAT_TATGTAGATCCAATGG_ATGGCGATTCATGCAA	P
CCACGCGCGGTACGTC_TGCCACACACGACGAT_TATGTAGATCCAATGG_TAGCGAAATTACAACA	P
TCTAGCGCGGCCGAAT_CTATGAGGTAGAAACA_GATAGATATAGTAAGT_CAACGAAAAATGCGAT	C
TGCTAAAAAGATCTAG_TGTGTTCAGGGGGCTG_TGAGGGGGCCGGTTTG_GGTCCTCAAGGGTTGC	P
TGCTAAAAAGATCTAG_TGTGTTCAGGGGGCTG_TGAGGGGGCCGGTTTG_TAGGGCGTGCTCTCGT	P
TGCTAAAAAGATCTAG_TGTGTTCAGGGGGCTG_TGAGGGGGCCGGTTTG_CCGTGCTACTGCTCGC	P
TACCCGATGGCGAAGC_GTTCCAGTCCTTATCA_ATGGAGATTAAATTAT_CTTCGCTTTCGGGGTG	P;R(B)
CCACGCGCGGTACGTC_TGCCACACACGACGAT_TTCACTACCAATCTCC_GATGTTGCCTGGCATA	P
TCCATTGAGAACAACT_TGCACACCCATGAGTA_CACGACATGGTAATGT_TGCGGTGTACTACAGA	P
TCCATTGAGAACAACT_ACCTAGGTCGTGGGAG_AACGTTAAGTGTTCAT_GTCATTCTAAGGCCGG	A
ACAATCCGAATGAAGG_CTTGGAACTGCGTTGA_GTAGATCTTTGTAGAT_GGGAAGACCGGGTAAC	P
ACAATCCGAATGAAGG_CTTGGAACTGCGTTGA_GTAGATCTTTGTAGAT_AGCAGATAAAAATCCA	P
CGCGGTGGAACGGAGG_CGCAACATGTAAACTT_TGCCGCTCCACCGCTA_GCAGGTCGGCTAACGT	P
CTAGAGACACGTCTAC_ATGGTATATCAATGGC_CCACTTAGTCATGACT_CTGAGAGCGCGTTTGG	B
CGCGGTGGAACGGAGG_CGCAACATGTAAACTT_TCTACGAACGAGTAGC_CAGATGAATCGACCTT	P;R(C)
CGCGGTGGAACGGAGG_CGCAACATGTAAACTT_TCTACGAACGAGTAGC_ATGAAGGTCTACGTTC	C
CGCGGTGGAACGGAGG_CGCAACATGTAAACTT_CTATTACGTCACGCGC_TGTCGGATCAACTTGC	P
TCTAGCGCGGCCGAAT_CTATGAGGTAGAAACA_CAGTGCTGCACACGAC_CCAACGAAGTGATTCT	P
CGCGGTGGAACGGAGG_CGCAACATGTAAACTT_GCCGCTAGCTTGTGGC_CGACGCGGCCCCATAG	P
TCCATTGAGAACAACT_ACCTAGGTCGTGGGAG_AAATCCTATATAAAGA_AAACGCACATCGAATG	P
GTACCAAAGAGAGCAG_CGGGAGCGCTTGGGTT_ATTGCTCGTGCAGAAG_ACGAGGCTACGCTATA	P
TCTAGCGCGGCCGAAT_CTATGAGGTAGAAACA_TTAAGAGTAAGAGAGT_ACCATCAATGCTGCGA	C
TCTAGCGCGGCCGAAT_CTATGAGGTAGAAACA_TTAAGAGTAAGAGAGT_ATCAGTGTAAAGCCCA	C
TCTAGCGCGGCCGAAT_CTATGAGGTAGAAACA_TTAAGAGTAAGAGAGT_GTGATCAGCACGCTAT	P
TCTAGCGCGGCCGAAT_CTATGAGGTAGAAACA_TTAAGAGTAAGAGAGT_TAGTAAGAATCATCAT	P
TCTAGCGCGGCCGAAT_CTATGAGGTAGAAACA_TTAAGAGTAAGAGAGT_GCGTTTATGACGAACC	P
TCTAGCGCGGCCGAAT_CTATGAGGTAGAAACA_TTAAGAGTAAGAGAGT_TCAACGTGGAGGCGGA	P
TCTAGCGCGGCCGAAT_CTATGAGGTAGAAACA_TTAAGAGTAAGAGAGT_CGAACTATGAAAGCCG	P
TCTAGCGCGGCCGAAT_CTATGAGGTAGAAACA_TTAAGAGTAAGAGAGT_TTCCCTATCCGAGGCC	P
TCTAGCGCGGCCGAAT_CTATGAGGTAGAAACA_TTAAGAGTAAGAGAGT_GTAGGGTCGCCGGTCA	P
TCTAGCGCGGCCGAAT_CTATGAGGTAGAAACA_TTAAGAGTAAGAGAGT_AGGGAACCGTCGGGTA	P
TCTAGCGCGGCCGAAT_CTATGAGGTAGAAACA_TTAAGAGTAAGAGAGT_TGTATTCCATGGCGAC	P
CGCGGTGGAACGGAGG_CGCAACATGTAAACTT_CCGTGTTAGACAAAAC_AACTCTCACACACAAC	A
TCTAGCGCGGCCGAAT_CTATGAGGTAGAAACA_TAAGTGCGTAAGTGAG_GCAATCAAGTCCAACG	P
TCTAGCGCGGCCGAAT_CTATGAGGTAGAAACA_TAAGTGCGTAAGTGAG_AGTGGTAACCTTATAG	P
TCTAGCGCGGCCGAAT_CTATGAGGTAGAAACA_TAAGTGCGTAAGTGAG_CGACGCCTTCTCCGCA	P
TCTAGCGCGGCCGAAT_CTATGAGGTAGAAACA_TAAGTGCGTAAGTGAG_AGCCGCTTGCTGCTGC	P
TCTAGCGCGGCCGAAT_CTATGAGGTAGAAACA_TAAGTGCGTAAGTGAG_GGTTTAAGCCCATATG	P
TCTAGCGCGGCCGAAT_CTATGAGGTAGAAACA_TAAGTGCGTAAGTGAG_CCCCGGACTTTGTAAA	P
TCTAGCGCGGCCGAAT_CTATGAGGTAGAAACA_TAAGTGCGTAAGTGAG_CAGATGGTCGGATATA	P
TCTAGCGCGGCCGAAT_CTATGAGGTAGAAACA_TAAGTGCGTAAGTGAG_TATGGCGCCAGGACCA	P;R(A)
TCTAGCGCGGCCGAAT_CTATGAGGTAGAAACA_TAAGTGCGTAAGTGAG_AGGCATGGGCTAAAGT	P
TCTAGCGCGGCCGAAT_CTATGAGGTAGAAACA_TAAGTGCGTAAGTGAG_AGGGCTATGAGCCATC	P
TCTAGCGCGGCCGAAT_CTATGAGGTAGAAACA_TAAGTGCGTAAGTGAG_AAGGCAGTCAGGATCT	P
TCTAGCGCGGCCGAAT_CTATGAGGTAGAAACA_TAAGTGCGTAAGTGAG_TCAACGTCGCAAGACT	P
TCTAGCGCGGCCGAAT_CTATGAGGTAGAAACA_TAAGTGCGTAAGTGAG_GGTAGCTCACCTTTCG	P
TCTAGCGCGGCCGAAT_CTATGAGGTAGAAACA_TAAGTGCGTAAGTGAG_TCAGGTCAAAAGCCAT	C
TCTAGCGCGGCCGAAT_CTATGAGGTAGAAACA_TAAGTGCGTAAGTGAG_CTGGTGTGTGGTGCGG	P
TCTAGCGCGGCCGAAT_CTATGAGGTAGAAACA_TAAGTGCGTAAGTGAG_CCATAACGCCGGGGCA	P
TCTAGCGCGGCCGAAT_CTATGAGGTAGAAACA_TAAGTGCGTAAGTGAG_CTTCTGACGACCGCTG	P
TCTAGCGCGGCCGAAT_CTATGAGGTAGAAACA_TAAGTGCGTAAGTGAG_TAGGTAAAGCCAAATT	P
TCTAGCGCGGCCGAAT_CTATGAGGTAGAAACA_TAAGTGCGTAAGTGAG_TGCCGTAATGGGGAAG	P
TCTAGCGCGGCCGAAT_CTATGAGGTAGAAACA_TAAGTGCGTAAGTGAG_CGGCCGCTCCGAAGTT	P
TTGCAGGGCAAGGCGC_ACGGACACCACTATAT_TTAGCTAACGAGTACC_GGGGAACAAATTGAGC	A;R(N)
CCACGCGCGGTACGTC_TGCCACACACGACGAT_CTGGGGTTTGTGTGAT_CGGCCTTCATAATGAG	P
TCTAGCGCGGCCGAAT_CTATGAGGTAGAAACA_CAATAATATGAGCCAA_TAGCAGTCCAATATGA	P
TCTAGCGCGGCCGAAT_CTATGAGGTAGAAACA_CAATAATATGAGCCAA_ACGTGTCGCGTTTCAT	P
TCTAGCGCGGCCGAAT_CTATGAGGTAGAAACA_CAATAATATGAGCCAA_GTCAGGTATCCCACAA	P
CGTATGAAACCTGGGG_GGCAGGTTTTGCGCGA_ATATTCCTAGAAATTC_ACGCTCTGGTGAAACC	P
CGTATGAAACCTGGGG_GGCAGGTTTTGCGCGA_ATATTCCTAGAAATTC_TAGAGCAAGAAAGTTT	P
CCACGCGCGGTACGTC_GGTATGTTAACGGAGA_GACGGCTCTAAGACAT_ATAAGAATCACACCGA	P
GTACCAAAGAGAGCAG_CGGGAGCGCTTGGGTT_GTACAACTTCCCGAGT_GGCAGACGTGGCTGCA	P
CGAAGCGATGCGTGTA_CGTGTAACCCTCGCAA_GCTAGGGTACAGTAAG_TAGAATCGACAGATCG	P
TCTAGCGCGGCCGAAT_CTATGAGGTAGAAACA_TCATCGCAGAAGCCTC_CCTCAATGAGCACTCG	P
CGCGGTGGAACGGAGG_CGCAACATGTAAACTT_TGTACCGCAATTATAC_GCGCCGGCTAATGAGT	P
GCAACCCTGCAACTTC_TCGGCGATGGTCGAAG_GTGGAAGTCGAATTAT_AAGGCGGGCTTGGATA	P
TCCATTGAGAACAACT_ACCTAGGTCGTGGGAG_TTGTCCCTAGTTGTGT_ATTAGCACAAGAGATA	P
TCCATTGAGAACAACT_ACCTAGGTCGTGGGAG_TTGTCCCTAGTTGTGT_TGTCGAACGGTATTAG	P
TCCATTGAGAACAACT_ACCTAGGTCGTGGGAG_TTGTCCCTAGTTGTGT_GTGACGTTTCGGGGGT	P
CCACGCGCGGTACGTC_TGCCACACACGACGAT_ATACGCAACTCGGTTT_ATGGCTTTAACAGCCA	A;R(P)
GTACCAAAGAGAGCAG_CGGGAGCGCTTGGGTT_CATGCAACAGCGTCAT_GGAGTGTCCATAGTAT	P
TAAGGTTCAAAACTCC_TAGACCTTGCCAACAT_CCTCGTGCTCCGATGG_CATTGTCTACACAACG	P
TAAGGTTCAAAACTCC_TAGACCTTGCCAACAT_CCTCGTGCTCCGATGG_GATCCGCCTCCACCCA	P
TTGTCATCAGCGGTAA_CACGACTGGCACTTTT_GACAGCAGTATTGATT_AACGGAGAGCTATTAT	P
CGCGGTGGAACGGAGG_CGCAACATGTAAACTT_TATTGCCAGGGGAAGG_ATAGTCCGCTTGTAAA	P
CGCGGTGGAACGGAGG_CGCAACATGTAAACTT_TATTGCCAGGGGAAGG_CGTCCGGCCTTGACAA	P
TCTAGCGCGGCCGAAT_CTATGAGGTAGAAACA_CCGGAAAGAGTACGAC_CTAATGGGCTGATCTG	C
TCTAGCGCGGCCGAAT_CTATGAGGTAGAAACA_CCGGAAAGAGTACGAC_GGCGTCGGGTTAGTGT	C
TCTAGCGCGGCCGAAT_CTATGAGGTAGAAACA_CCGGAAAGAGTACGAC_AGGTCCCCGACTTTAA	P
TCTAGCGCGGCCGAAT_CTATGAGGTAGAAACA_CCGGAAAGAGTACGAC_ACGCGTATACTAGCGG	P
TCTAGCGCGGCCGAAT_CTATGAGGTAGAAACA_CCGGAAAGAGTACGAC_CGTTAGTCCTTTTGAT	P
TCTAGCGCGGCCGAAT_CTATGAGGTAGAAACA_CCGGAAAGAGTACGAC_CCATCACAAGATCACA	P
TCTAGCGCGGCCGAAT_CTATGAGGTAGAAACA_CCGGAAAGAGTACGAC_CCTCCTGTTCATTACC	P
TCTAGCGCGGCCGAAT_CTATGAGGTAGAAACA_CCGGAAAGAGTACGAC_AGAAGCCAACGTCGCG	P
TCTAGCGCGGCCGAAT_CTATGAGGTAGAAACA_CCGGAAAGAGTACGAC_TACTACCTGAATGATC	P
TCTAGCGCGGCCGAAT_CTATGAGGTAGAAACA_CCGGAAAGAGTACGAC_TGCGTAGAATATTGCG	P
TCTAGCGCGGCCGAAT_CTATGAGGTAGAAACA_CCGGAAAGAGTACGAC_TCCGGGCGACTTTGGC	P
TCTAGCGCGGCCGAAT_CTATGAGGTAGAAACA_CCGGAAAGAGTACGAC_CTACCATGTGTTCGGA	P
TCTAGCGCGGCCGAAT_CTATGAGGTAGAAACA_CCGGAAAGAGTACGAC_CGCTGCTGGACTGTCT	C
TCTAGCGCGGCCGAAT_CTATGAGGTAGAAACA_CCGGAAAGAGTACGAC_CAACCTTTTTGCGAGA	P
TCTAGCGCGGCCGAAT_CTATGAGGTAGAAACA_CCGGAAAGAGTACGAC_AATCGGGACTCCTATG	P
TCTAGCGCGGCCGAAT_CTATGAGGTAGAAACA_CCGGAAAGAGTACGAC_GGACACGTTTCGGCCC	P
TCTAGCGCGGCCGAAT_CTATGAGGTAGAAACA_CCGGAAAGAGTACGAC_ATGCCGAGAACGTAGT	P
TCTAGCGCGGCCGAAT_CTATGAGGTAGAAACA_CCGGAAAGAGTACGAC_AAGCATATCCCGCAGC	P
TCTAGCGCGGCCGAAT_CTATGAGGTAGAAACA_CCGGAAAGAGTACGAC_GCTGACGCTGTCGATC	P
TCTAGCGCGGCCGAAT_CTATGAGGTAGAAACA_CCGGAAAGAGTACGAC_CGAATCAAACGTCCTC	P
TCTAGCGCGGCCGAAT_CTATGAGGTAGAAACA_CCGGAAAGAGTACGAC_TAAAAACGTCTTCCTA	P
TCTAGCGCGGCCGAAT_CTATGAGGTAGAAACA_CCGGAAAGAGTACGAC_GGGTTCGCAGGGTCTG	P
TCTAGCGCGGCCGAAT_CTATGAGGTAGAAACA_CCGGAAAGAGTACGAC_TAGGGAGTGAACCGTT	P
TCTAGCGCGGCCGAAT_CTATGAGGTAGAAACA_CCGGAAAGAGTACGAC_TCAAGGGGCGCAGCCG	P
TCAGGCCACGTAAGAG_CTGCGAATACGGTGTG_TTCCGGTGATCGGGGA_CAGAATCCTGAGCCTG	P
CGCGGTGGAACGGAGG_CGCAACATGTAAACTT_CTCGCTGTCAGTTACC_GAATTGGTTCAACTGC	P
CGCGGTGGAACGGAGG_CGCAACATGTAAACTT_CTCGCTGTCAGTTACC_TCTCTCAGTTTGCTGG	P
TGCTAAAAAGATCTAG_TGTGTTCAGGGGGCTG_TTATCGGACAGCGTGC_ATAGCACTCGTCGTGA	P
TGCTAAAAAGATCTAG_TGTGTTCAGGGGGCTG_TTATCGGACAGCGTGC_CTGACATCAACATCAG	P
TGCTAAAAAGATCTAG_TGTGTTCAGGGGGCTG_TTATCGGACAGCGTGC_GGGGACCTTGCGTCGC	P
CGCGGTGGAACGGAGG_CGCAACATGTAAACTT_AAAAAACTCGCGGGGT_TTGGGGGTAGTTTGAG	P
CGCGGTGGAACGGAGG_CGCAACATGTAAACTT_AAAAAACTCGCGGGGT_GACACCTCTTCCTACA	P
TGCGGCATAGTCCTCG_GTAGGTTATGCGGAAG_TAGCAAATGCGGATTC_GTGGGCAATGATACTG	P
GCAACCCTGCAACTTC_CAAGGAGGGTACTTCG_CCGCGGGCTACTACAT_TGATGGTGGTGCACCA	P
GCAACCCTGCAACTTC_TCGGCGATGGTCGAAG_AGGAAACATTCTTGTG_GCGCTGCTGGTTTCAA	P
CAATGGTCTGATCTAT_CAGTATTGTGACGCAT_AAACCCCCGGCCGATT_ATAGATGTTTCGTAGC	P
AACGAGGCAGCGTTTT_CTCCTGGACACGTCTG_AGAGACACCACTGCAA_GCTCATGATAGGATAT	P
CGCGGTGGAACGGAGG_CGCAACATGTAAACTT_CAATCGTCAGAAGTGC_CCGTGTGCACGGTATA	P;R(A)
CGCGGTGGAACGGAGG_CGCAACATGTAAACTT_ACCAGCTATTCTCGCT_AGGCGCTGCGAGTGTA	P
GCAACCCTGCAACTTC_CATACGGCAGTCAGTA_TTCTTAATACTTGCGG_CGCTCAAAAAAGTTCG	P
CGAAGCGATGCGTGTA_CGTGTAACCCTCGCAA_TCTGTGAGATGGAGTC_ACATTGCGCACAGGAT	P
CGAAGCGATGCGTGTA_CGTGTAACCCTCGCAA_TCTGTGAGATGGAGTC_GTCGCTGCTTCAGAGG	P
GTACCAAAGAGAGCAG_CGGGAGCGCTTGGGTT_CTTGAGGTGAAATCTC_AGCAGTAGTATTCCTC	P
TCCATTGAGAACAACT_ACCTAGGTCGTGGGAG_AAGGTCTACCATCCAG_GGTTGATCCTAAGTAG	P
GTACCAAAGAGAGCAG_CGGGAGCGCTTGGGTT_GCATAATACGATTTTC_TCTACGGACTGTAGTC	P
GCAACCCTGCAACTTC_CAAGGAGGGTACTTCG_GCGCAGGTGGATGTCT_TCATGATAAGTAGAAT	P
AACGAGGCAGCGTTTT_CTCCTGGACACGTCTG_ATTCTCGGATGAAGCC_CTGCTTAGAGGTGTGC	P
TGCTAAAAAGATCTAG_TGTGTTCAGGGGGCTG_TAGAACCCGAGAGGGT_ACATCTCAAACTAGAA	P
TGCTAAAAAGATCTAG_TGTGTTCAGGGGGCTG_TAGAACCCGAGAGGGT_TATTAGCGCCCTCTCC	P
TGCTAAAAAGATCTAG_TGTGTTCAGGGGGCTG_TAGAACCCGAGAGGGT_TCCGGTGTAGATAGAG	P
TCTAGCGCGGCCGAAT_CTATGAGGTAGAAACA_GTACAGACTGCATGCT_GTCGCGCAGGCGAATT	P
TCTAGCGCGGCCGAAT_CTATGAGGTAGAAACA_GTACAGACTGCATGCT_CTATAACAATTGCGGA	A
TCTAGCGCGGCCGAAT_CTATGAGGTAGAAACA_GTACAGACTGCATGCT_GAGTTACCAAAGTAAT	P
CGAAGCGATGCGTGTA_CGTGTAACCCTCGCAA_CCCAGCGACGCCTTTA_CCTGGTTCCTGTTGCG	P
TAAATCTTGTCAGTCA_TCTGGACCCGGTAGAG_AATAAGCAAAGTCAGT_AAGGACATACTGTCCC	A
TCTAGCGCGGCCGAAT_CTATGAGGTAGAAACA_GCACGCTCGTGGACCT_ATATCCGTTAGCAGCT	P
TCCATTGAGAACAACT_TGCACACCCATGAGTA_TTTAGACAAATGAGTC_CATAAAAATCGCTAGG	P
TCCATTGAGAACAACT_TGCACACCCATGAGTA_TTTAGACAAATGAGTC_GCCACCCACCCTCTTC	P
TCCATTGAGAACAACT_ACCTAGGTCGTGGGAG_TACCCCACGGTCGTAC_AGAGATCCAAAGTAGA	P
TGCGGCATAGTCCTCG_GTAGGTTATGCGGAAG_GTCTAAGGTGTTACCG_GGCGGTATTAATTAGC	P
GTGCGGACCCCGTGAT_ATCCAAAATCTGTGAC_CAACGCAGACAGATTT_TCACTAGTGACCGCCG	P
CGCGGTGGAACGGAGG_CGCAACATGTAAACTT_CCCACTAGGATTTCTC_ACGTATTGGCGCAGGC	C
AACGAGGCAGCGTTTT_CTCCTGGACACGTCTG_CACCGTCTTGATTGGT_CGGAAGGTCCACGTTA	P
CGCGGTGGAACGGAGG_CGCAACATGTAAACTT_ACTGAGTAGGACTCAT_TGTCGAGGGATCGCTC	P
CGCGGTGGAACGGAGG_CGCAACATGTAAACTT_ACTGAGTAGGACTCAT_CCGCTGGTCTCGGATC	P
TCCATTGAGAACAACT_TGCACACCCATGAGTA_CTCGCAGTGCAAATTT_AATCCGGTACCGAGCA	P
AACGAGGCAGCGTTTT_CTCCTGGACACGTCTG_GTAAGACACTATGTGG_ACGCTTTGTCTCTGTT	P
TCCATTGAGAACAACT_ACCGTCTAAAGCGTGC_ACTGAAGTATCTGGGC_TTTTGCCGAATGCTTA	P
TCTAGCGCGGCCGAAT_CTATGAGGTAGAAACA_CGCTTAGTACCCGGAT_ACTTAACGGAATGAGT	P
TCTAGCGCGGCCGAAT_CTATGAGGTAGAAACA_CGCTTAGTACCCGGAT_CGTCTGCGCTAGACAG	P
TCTAGCGCGGCCGAAT_CTATGAGGTAGAAACA_CGCTTAGTACCCGGAT_GAGTACACAATGTGTG	P
TCTAGCGCGGCCGAAT_CTATGAGGTAGAAACA_CGCTTAGTACCCGGAT_CAAGAAGACAATGTGA	P
TCTAGCGCGGCCGAAT_CTATGAGGTAGAAACA_CGCTTAGTACCCGGAT_ATCCGACTGCGATATA	P
TCTAGCGCGGCCGAAT_CTATGAGGTAGAAACA_CGCTTAGTACCCGGAT_AGTCGTTGCGCAAGCG	C
TCTAGCGCGGCCGAAT_CTATGAGGTAGAAACA_CGCTTAGTACCCGGAT_AGGCATCACACTGGTA	P
TCTAGCGCGGCCGAAT_CTATGAGGTAGAAACA_CGCTTAGTACCCGGAT_TAGACGCAAGCTGTCA	P
TCTAGCGCGGCCGAAT_CTATGAGGTAGAAACA_CGCTTAGTACCCGGAT_TATACCTCACCGCGGG	P
TCTAGCGCGGCCGAAT_CTATGAGGTAGAAACA_CGCTTAGTACCCGGAT_TGAGGCGTACAGCAGG	P
TCTAGCGCGGCCGAAT_CTATGAGGTAGAAACA_CGCTTAGTACCCGGAT_CGCAAGGCACGGCCCT	P
TCTAGCGCGGCCGAAT_CTATGAGGTAGAAACA_CGCTTAGTACCCGGAT_GACACAGAACTAGTTA	P
TCTAGCGCGGCCGAAT_CTATGAGGTAGAAACA_CGCTTAGTACCCGGAT_AACGGAGCAACTGCAG	P
TCTAGCGCGGCCGAAT_CTATGAGGTAGAAACA_CGCTTAGTACCCGGAT_GGGGTCATGGGTATGC	P
GCAACCCTGCAACTTC_CAAGGAGGGTACTTCG_TAAGGCGCGTAGGCCT_CCGAGGAAATTCTTTG	P
GTACCAAAGAGAGCAG_CGGGAGCGCTTGGGTT_TACGCCTATGAAAAAT_CAGATTCCGATGGTAA	P
TCTAGCGCGGCCGAAT_CTATGAGGTAGAAACA_GAAGGCGGTTTGGCAT_CCGCCTCGTAACCAGC	P
TCTAGCGCGGCCGAAT_CTATGAGGTAGAAACA_GAAGGCGGTTTGGCAT_AACGACCTTCTAAGTG	P
TCTAGCGCGGCCGAAT_CTATGAGGTAGAAACA_GAAGGCGGTTTGGCAT_CATTCCCCCACCTGTT	P
TCTAGCGCGGCCGAAT_CTATGAGGTAGAAACA_GAAGGCGGTTTGGCAT_TGGGGATTACGGGCTT	P
TCTAGCGCGGCCGAAT_CTATGAGGTAGAAACA_GAAGGCGGTTTGGCAT_GTTGCCACTACGGGCA	P
TCTAGCGCGGCCGAAT_CTATGAGGTAGAAACA_GAAGGCGGTTTGGCAT_GGTCATTCATTATCCT	P
TCTAGCGCGGCCGAAT_CTATGAGGTAGAAACA_GAAGGCGGTTTGGCAT_CAGTAAGCCGCTCCAA	P
TCTAGCGCGGCCGAAT_CTATGAGGTAGAAACA_GAAGGCGGTTTGGCAT_AAAATGGGATAGGTCC	C;R(P)
TCTAGCGCGGCCGAAT_CTATGAGGTAGAAACA_GAAGGCGGTTTGGCAT_GAATGGAGATAGCATA	P
TCTAGCGCGGCCGAAT_CTATGAGGTAGAAACA_GAAGGCGGTTTGGCAT_CATTGCGGCGATTCCC	P
TCTAGCGCGGCCGAAT_CTATGAGGTAGAAACA_GAAGGCGGTTTGGCAT_AGCTGATATGCCATGT	P
TCTAGCGCGGCCGAAT_CTATGAGGTAGAAACA_GAAGGCGGTTTGGCAT_GAAGCCTATAGCTATT	P
TCTAGCGCGGCCGAAT_CTATGAGGTAGAAACA_GAAGGCGGTTTGGCAT_TTAATCGGAGCGATAC	P
TCTAGCGCGGCCGAAT_CTATGAGGTAGAAACA_GAAGGCGGTTTGGCAT_ATGACCCAGCAAAGGT	P
TCTAGCGCGGCCGAAT_CTATGAGGTAGAAACA_GAAGGCGGTTTGGCAT_GCGGGAATGCTTAAGT	P
TCTAGCGCGGCCGAAT_CTATGAGGTAGAAACA_GAAGGCGGTTTGGCAT_TGCTGCATTGTGGGAG	C
TCTAGCGCGGCCGAAT_CTATGAGGTAGAAACA_GAAGGCGGTTTGGCAT_CTCGGCAATTCCCCGG	P
TCTAGCGCGGCCGAAT_CTATGAGGTAGAAACA_GAAGGCGGTTTGGCAT_AGTAGGTTATGTAAAG	P
TCTAGCGCGGCCGAAT_CTATGAGGTAGAAACA_GAAGGCGGTTTGGCAT_CACGCCCCATTTCAAC	P
TCTAGCGCGGCCGAAT_CTATGAGGTAGAAACA_GAAGGCGGTTTGGCAT_AAAGCCTCTGAGACTA	P
TCTAGCGCGGCCGAAT_CTATGAGGTAGAAACA_GAAGGCGGTTTGGCAT_AACGGAATAGAGTATG	P
TCTAGCGCGGCCGAAT_CTATGAGGTAGAAACA_GAAGGCGGTTTGGCAT_TCAACAGGGGGTAGAT	P
TTGACAACTCCGCCGT_GAAGCCTAATACATAA_CTCGATTTGGTGAGAT_AAGCAGGGCTCTGGCT	P
TTGACAACTCCGCCGT_GAAGCCTAATACATAA_CTCGATTTGGTGAGAT_CTGGAGCCAGTAGACG	P
TCTAGCGCGGCCGAAT_CTATGAGGTAGAAACA_GATGTGAGCATTCTAC_GGTCTACCTCAGAAGT	P
TCTAGCGCGGCCGAAT_CTATGAGGTAGAAACA_GATGTGAGCATTCTAC_AGCGTTTGTAAGCAGT	P
CCACGCGCGGTACGTC_TGCCACACACGACGAT_CAGATCGCTGTTAGAG_CCTTAAAAACAACGGT	P
TGCTAAAAAGATCTAG_TGTGTTCAGGGGGCTG_TATCAGCCGGTTAAAT_GGGTTAACGCGCTGTG	P
TGCTAAAAAGATCTAG_TGTGTTCAGGGGGCTG_TATCAGCCGGTTAAAT_TAAGCCGGCTGAGTAT	P
GTACCAAAGAGAGCAG_CGGGAGCGCTTGGGTT_GGTCTTCCAACACCAT_GAGATGGTCAACGAAT	P
GTACCAAAGAGAGCAG_CGGGAGCGCTTGGGTT_GGTCTTCCAACACCAT_ATACTGATCTGGACGA	P
CGCGGTGGAACGGAGG_CGCAACATGTAAACTT_GCTTAGATGTTGGAGT_GAGATGGACGGTAAGC	P
CGCGGTGGAACGGAGG_CGCAACATGTAAACTT_GCTTAGATGTTGGAGT_AGAAGCGGAGTAATGT	P
GCAACCCTGCAACTTC_TCGGCGATGGTCGAAG_GTACTTGCGATTCATC_ATAGTAGGCTCTTCCA	P
CGCGGTGGAACGGAGG_CGCAACATGTAAACTT_CAAACAGCTGATCCTG_AGGCATGAGGTCTGCC	P
CGCGGTGGAACGGAGG_CGCAACATGTAAACTT_CAAACAGCTGATCCTG_ATGATAAGCTGCCATT	P
CGCGGTGGAACGGAGG_CGCAACATGTAAACTT_CAAACAGCTGATCCTG_AGTACGCAGGGCACGG	P
CCACGCGCGGTACGTC_TGCCACACACGACGAT_TAGTTCCCATTCCGGT_CTCTGATGTGTGGAAC	P
GCAACCCTGCAACTTC_CAAGGAGGGTACTTCG_ACAGCGATGTCCATCC_GCTTTAGAACAATGTG	P
GTTTAATTTAATCGTG_TCCACTGCTTTAAGTG_TAACGAACACGTACGC_TAAAATGCGATAAGTG	P
CGCGGTGGAACGGAGG_CGCAACATGTAAACTT_AGATGTGCACGGACAC_CAACGTGCACAAAGGG	P
GTACCAAAGAGAGCAG_CGGGAGCGCTTGGGTT_CTGATATGTCGCGTGC_TGTCCACTGACGCTCA	P
GTACCAAAGAGAGCAG_CGGGAGCGCTTGGGTT_CTGATATGTCGCGTGC_CGAATGGAATGGCATG	P
CGCGGTGGAACGGAGG_CGCAACATGTAAACTT_CTTGGGTAAAAAAGCC_CATGCGGCCGACATAG	P
CGCGGTGGAACGGAGG_CGCAACATGTAAACTT_CTTGGGTAAAAAAGCC_TCTACCGGGAAAGTCG	P
TGCGGCATAGTCCTCG_GTAGGTTATGCGGAAG_GCATGATGCTCGTCGT_CAAGGCAGAGCAAATC	P
ACAATCCGAATGAAGG_CTTGGAACTGCGTTGA_CAGGATGGGGATGCTC_TCGCCCAGCGGACCCC	P
GCAACCCTGCAACTTC_CAAGGAGGGTACTTCG_TGATCCGCTCTCCCGT_CGAGGACTGTAGGACG	P
CGCGGTGGAACGGAGG_CGCAACATGTAAACTT_TACCAGCAGCAATATA_GTCCCCGATAGACTTA	P
CGCGGTGGAACGGAGG_CGCAACATGTAAACTT_GTGTGTGTTGTTGTGG_TTAAAACGAGGCGTTA	P
CGCGGTGGAACGGAGG_CGCAACATGTAAACTT_TGGAAATGAATCGAGA_CGTGCCCATGGACAAG	P
TCCATTGAGAACAACT_TGCACACCCATGAGTA_ACACAAAGCATCTGTT_CTCCCGCCCTTGGCGT	P
TCCATTGAGAACAACT_ACCTAGGTCGTGGGAG_TAACGCGCAATCGCGT_TCACCGAAGTAGACAT	P
GTACCAAAGAGAGCAG_CGGGAGCGCTTGGGTT_ACTGCTTGCCTGAATT_GAGTCAACTTTCCACG	P
CGAAGCGATGCGTGTA_CGTGTAACCCTCGCAA_GGCTCTACACTCGGTC_TGAAGGTCCGTGCGTG	P
TGCGGCATAGTCCTCG_GTAGGTTATGCGGAAG_GACCAAATGGGGATAT_TTGGTGACGTCTTTAC	P
TCTAGCGCGGCCGAAT_CTATGAGGTAGAAACA_GCCCATGGATAGATTG_CGGGCCCGCGGCCTCA	P
TCTAGCGCGGCCGAAT_CTATGAGGTAGAAACA_GCCCATGGATAGATTG_GGTACGCGGTATTCGA	P
GCAACCCTGCAACTTC_TCTGGACAACGAGCGC_GACGGTCTATTCTCGA_AGGAACGCCGATAGGA	P
GTACCAAAGAGAGCAG_CGGGAGCGCTTGGGTT_CGTCGGAATATTCAAT_ACGCAACCTGTCGAAA	P
CCACGCGCGGTACGTC_GGTATGTTAACGGAGA_GGTCAGCTTGGATGCA_CTTAATGCCAATAGAT	P
CGCGGTGGAACGGAGG_CGCAACATGTAAACTT_AAGATTCGCCGGTGTC_AAAGTAAACTCAAGCT	P
CCACGCGCGGTACGTC_GGTATGTTAACGGAGA_CTCGAAGCAAGGGACT_GGTTAGAAGTTATGTG	P
TGCTAAAAAGATCTAG_TGTGTTCAGGGGGCTG_TGGCGGCATTTCGCGG_CTACGACCCTTGACAG	P
CCTTGACCTCCGACTA_AAATCTTCCTACGCAA_GTATTCATCACAGCAG_AACGGCGCTATGTAAA	P
TTGACAACTCCGCCGT_GAAGCCTAATACATAA_AAAGCGGAGTCCAATA_GTTTAAGGAGGGGGAG	P
ACAATCCGAATGAAGG_CTTGGAACTGCGTTGA_GTCGACAGAACAACAG_CTGCTAGAGAAGATGT	P
GCAACCCTGCAACTTC_CAAGGAGGGTACTTCG_TAGCGCTCTCTAGACC_GGACAGGCTATGTGGT	P
GCAACCCTGCAACTTC_CAAGGAGGGTACTTCG_TAGCGCTCTCTAGACC_ATGAGGACCCGAAGCT	P
GCAACCCTGCAACTTC_CAAGGAGGGTACTTCG_TAGCGCTCTCTAGACC_AGCCCATACACTCTTA	P
CGCGGTGGAACGGAGG_CGCAACATGTAAACTT_AAACTTAGGACGTTAT_AAGTCGAGTAGGGCAA	P
CGCGGTGGAACGGAGG_CGCAACATGTAAACTT_AAACTTAGGACGTTAT_CTGAAAGAGAAAACTT	P
CGCGGTGGAACGGAGG_CGCAACATGTAAACTT_AAGCCCTAATTTCCTT_ACCTGCGTGGCACGCG	P
GTGCGGACCCCGTGAT_ATCCAAAATCTGTGAC_CCGGGAATAGACTCGC_AAAAAAGTTCCACTCA	P
GTGCGGACCCCGTGAT_ATCCAAAATCTGTGAC_CCGGGAATAGACTCGC_CTCTATGGAGAAATTG	P
GTGCGGACCCCGTGAT_ATCCAAAATCTGTGAC_CCGGGAATAGACTCGC_GAGAACTTGAAAGATT	P
TCCATTGAGAACAACT_TGCACACCCATGAGTA_GCTAGTCAAAGTCCGT_CAGTAAGTGGCACGGC	P
TCCATTGAGAACAACT_TGCACACCCATGAGTA_CGGTCCCAGTTGTATG_CCAATCGCCGAGGCTT	A
CGCGGTGGAACGGAGG_CGCAACATGTAAACTT_TTGATCAGCAGCAGCT_AACCTTGGACATGCGC	P
CGCGGTGGAACGGAGG_CGCAACATGTAAACTT_CCTCTAAACTTTGGGT_GTTGTACGCATACCCC	P
TCTAGCGCGGCCGAAT_CTATGAGGTAGAAACA_GATAGATATAGTAAGT_ATTCGGCTCATAAGGG	C
TCTAGCGCGGCCGAAT_CTATGAGGTAGAAACA_GATAGATATAGTAAGT_CGGAGTATCTAAGGCC	P
TCTAGCGCGGCCGAAT_CTATGAGGTAGAAACA_GATAGATATAGTAAGT_ACATCCACGGGTTCGG	P
TCTAGCGCGGCCGAAT_CTATGAGGTAGAAACA_GATAGATATAGTAAGT_CCCGTGAAGGACATTT	C
TCTAGCGCGGCCGAAT_CTATGAGGTAGAAACA_GATAGATATAGTAAGT_GTACCGCGTGTGCCTT	P
TCTAGCGCGGCCGAAT_CTATGAGGTAGAAACA_GATAGATATAGTAAGT_CTGGCGAAGGTAGCCA	P
TCTAGCGCGGCCGAAT_CTATGAGGTAGAAACA_GATAGATATAGTAAGT_CAATGCGACCACGAAG	P
TCTAGCGCGGCCGAAT_CTATGAGGTAGAAACA_GATAGATATAGTAAGT_ATAGAGCTCCTAGTTC	P
TCTAGCGCGGCCGAAT_CTATGAGGTAGAAACA_GATAGATATAGTAAGT_GATGAGCGATCGATGT	P
TCTAGCGCGGCCGAAT_CTATGAGGTAGAAACA_GATAGATATAGTAAGT_TCAGCGTACGTACCTG	P
TCTAGCGCGGCCGAAT_CTATGAGGTAGAAACA_GATAGATATAGTAAGT_CTCACGCAAATGGACT	P
TCTAGCGCGGCCGAAT_CTATGAGGTAGAAACA_GATAGATATAGTAAGT_GGTAAGGACCACACAC	P
TCTAGCGCGGCCGAAT_CTATGAGGTAGAAACA_GATAGATATAGTAAGT_TTGGCCCCGATTCGTC	P
TCTAGCGCGGCCGAAT_CTATGAGGTAGAAACA_GATAGATATAGTAAGT_TGCATCAGGTGTAATT	P
TCTAGCGCGGCCGAAT_CTATGAGGTAGAAACA_GATAGATATAGTAAGT_TTCAATCGCTATGCAG	P
TCTAGCGCGGCCGAAT_CTATGAGGTAGAAACA_GATAGATATAGTAAGT_TCGTAACCTATTGCCA	P
TCTAGCGCGGCCGAAT_CTATGAGGTAGAAACA_GATAGATATAGTAAGT_AGTGTTGAGAGGCTGA	P
GCAACCCTGCAACTTC_CAAGGAGGGTACTTCG_ATACCCTGAAAAGCCC_GATCTACCACGGCGCA	P
AACGAGGCAGCGTTTT_CTCCTGGACACGTCTG_GAAGCTGCTTCGATAT_TTCGAATGACGCTCAG	P
AACGAGGCAGCGTTTT_CTCCTGGACACGTCTG_GAAGCTGCTTCGATAT_TGGCAAGTGCCATACC	P
CGAAGCGATGCGTGTA_CGTGTAACCCTCGCAA_GTTGAATTCAACGGGC_CCTGGCCCCAATGCCC	P
TCCATTGAGAACAACT_TGCACACCCATGAGTA_GAGTCGAAGCTGCGAT_TATGTGTTCGCAAAGT	P
CGAAGCGATGCGTGTA_CGTGTAACCCTCGCAA_AAGACGTAGGCGATGC_CAAGTGAGTAAGGTCT	P
TCCATTGAGAACAACT_TGCACACCCATGAGTA_ATTGTATCGGCAGCTT_ATTAGTGAGCACCGTT	P
TGCTAAAAAGATCTAG_TGTGTTCAGGGGGCTG_TGAGGGGGCCGGTTTG_CTTCGCCGTTAGTCAG	P
TGCTAAAAAGATCTAG_TGTGTTCAGGGGGCTG_TGAGGGGGCCGGTTTG_GGTCCTCAAGGGGTGC	P
TGCTAAAAAGATCTAG_TGTGTTCAGGGGGCTG_TGAGGGGGCCGGTTTG_TAGATGTAAACGTCAA	P
TGCTAAAAAGATCTAG_TGTGTTCAGGGGGCTG_TGAGGGGGCCGGTTTG_ATTGTCATGCGCTAAC	A
TGCGGCATAGTCCTCG_GTAGGTTATGCGGAAG_GTAAAGGTGGCCTGAC_CCAAAGAAGGTATATC	P
TAAGGTTCAAAACTCC_TATGGGGCGCCTAATT_TCCCGAGGAGCCCATT_CCTTAGACTCTGCAGA	P
GTTTGGCAAGACAGCA_TGGAGAGGGACTGAGT_TTGCAACCAACTATTC_GAACATCCGCGGGAAC	P;R(A)
GTTTGGCAAGACAGCA_TGGAGAGGGACTGAGT_TTGCAACCAACTATTC_AAAAATAGATAACGGG	P
GTACCAAAGAGAGCAG_CGGGAGCGCTTGGGTT_TTAGGAGGAAGTGCAC_GTGACCCAGATCTGGA	P
TCCATTGAGAACAACT_ACCTAGGTCGTGGGAG_ATGTCCGCCGCGTTTT_GGGATGGCACTATTAC	P
TCAGGCCACGTAAGAG_CTGCGAATACGGTGTG_CGGACCCACACGAGAA_TACACACGGAAGGACA	P
GTACCAAAGAGAGCAG_CGGGAGCGCTTGGGTT_TTCTTGAAAGAGGAGA_ACACTCTGGCAACTGG	P
GTACCAAAGAGAGCAG_CGGGAGCGCTTGGGTT_TTCACCCGAGGCTTGT_TACCGAGACAGATTGC	P
ACAATCCGAATGAAGG_CTTGGAACTGCGTTGA_ATAATGTCGTGCACTT_AATTCGTTCAGAGTCG	P
CGCGGTGGAACGGAGG_CGCAACATGTAAACTT_GATACAGTTTTTCGAA_GTGCAAATACGAATAG	P
CGCGGTGGAACGGAGG_CGCAACATGTAAACTT_GATACAGTTTTTCGAA_TGGAATATAGACCCAA	P
CGCGGTGGAACGGAGG_CGCAACATGTAAACTT_GATACAGTTTTTCGAA_CATAGGTCTGCTAACG	P
CGCGGTGGAACGGAGG_CGCAACATGTAAACTT_GATACAGTTTTTCGAA_AACTACGGGTTGACGG	P
CGCGGTGGAACGGAGG_CGCAACATGTAAACTT_GATACAGTTTTTCGAA_CAACCAGCATAGGGGG	P
TGCGGCATAGTCCTCG_GTAGGTTATGCGGAAG_TCAGAGGGGTGCCAAC_CCGACGGCGTAGTTAT	P
TGCGGCATAGTCCTCG_GTAGGTTATGCGGAAG_TCAGAGGGGTGCCAAC_CTCTACATAACATGCG	P
GTACCAAAGAGAGCAG_CGGGAGCGCTTGGGTT_GAACGACCATCCCACC_ATTGTCCGTTGGCGAT	P
GTACCAAAGAGAGCAG_CGGGAGCGCTTGGGTT_AGTTCATAGAAAGTAT_GCGCAGACTCCCGCAG	P
CCACGCGCGGTACGTC_TGCCACACACGACGAT_TTCACTACCAATCTCC_TGTAAGGTAGTTAGTG	P
TCCATTGAGAACAACT_ACCTAGGTCGTGGGAG_TCCACGTAGTTTCGTC_GCGCGGCTATATGACC	P
GCAACCCTGCAACTTC_TCAGGGACGGCGGCAT_CGATGCCGGGAGTTAT_TGCGGTCAGCTCTAAG	P
GTACCAAAGAGAGCAG_CGGGAGCGCTTGGGTT_CCCCACTTCATTTAAG_AAGTGAACGGGGGTCC	P
GTACCAAAGAGAGCAG_CGGGAGCGCTTGGGTT_ACAGATAACGCTACGT_GTTGGTTCAACAGGCG	P
GTACCAAAGAGAGCAG_CGGGAGCGCTTGGGTT_TGTGGCGATGCATGGG_CTTAAGACGAGAGTGC	P
TCCATTGAGAACAACT_ACCTAGGTCGTGGGAG_AACGTTAAGTGTTCAT_AAGCCTACTGCTTTGT	P
CCTTGACCTCCGACTA_AAATCTTCCTACGCAA_TCCTGCGAGTGACAGG_AAGGTTATGGGTAAAG	P
TCCATTGAGAACAACT_ACCGTCTAAAGCGTGC_GATGTTCGCGTGTTCA_CATACTACACTCGCAG	P
ACAATCCGAATGAAGG_CTTGGAACTGCGTTGA_GTAGATCTTTGTAGAT_ACATGGCAATAAGGTG	P
ACAATCCGAATGAAGG_CTTGGAACTGCGTTGA_GTAGATCTTTGTAGAT_GATAGGAACAGGTCGA	P
ACAATCCGAATGAAGG_CTTGGAACTGCGTTGA_GTAGATCTTTGTAGAT_GGCCCACTCAATTCGC	P
ACAATCCGAATGAAGG_CTTGGAACTGCGTTGA_GTAGATCTTTGTAGAT_CTGGCAATGTGGCATT	P
ACAATCCGAATGAAGG_CTTGGAACTGCGTTGA_GTAGATCTTTGTAGAT_AGCCCAATGACCGTCA	P
ACAATCCGAATGAAGG_CTTGGAACTGCGTTGA_GTAGATCTTTGTAGAT_ATCCCCAATGTAACGC	P
ACAATCCGAATGAAGG_CTTGGAACTGCGTTGA_GTAGATCTTTGTAGAT_AAAACGGTCACAGGAT	P
TCCATTGAGAACAACT_ACCTAGGTCGTGGGAG_AGAGGAAAGTATTAAT_ACAGTCAGGCTTTTAA	P
CGCGGTGGAACGGAGG_CGCAACATGTAAACTT_GAGAAACTCCAATTAC_ACGGCGTTACAATGGG	P
TAGTGGCCTCCCAGAA_CCTCTATCAATAGTTA_AGCACAGTAGATCGTG_ACTATACGTGAGAGGG	P
GCAACCCTGCAACTTC_CAAGGAGGGTACTTCG_TTCAGCACACTAACGT_ACTGGGAGTGCTAATG	P;R(A)
TCTAGCGCGGCCGAAT_CTATGAGGTAGAAACA_CAGGCACTCACGTTAC_GTCAGAATTCGGAAAA	A
TCTAGCGCGGCCGAAT_CTATGAGGTAGAAACA_CAGGCACTCACGTTAC_GTTTGCAACGCGCAGC	P
TCTAGCGCGGCCGAAT_CTATGAGGTAGAAACA_CAGGCACTCACGTTAC_CCTGTACCAGGCATAC	P
TCTAGCGCGGCCGAAT_CTATGAGGTAGAAACA_CAGGCACTCACGTTAC_GGTACTAACAATCGCA	P
TCTAGCGCGGCCGAAT_CTATGAGGTAGAAACA_CAGGCACTCACGTTAC_CTCGTTTGAAGTGTGC	P
TTATAAACACCCTTCC_CCTGGCGTGTCGAATC_GCAAACCACGATACAT_CCTAAGCGGCTTAGCA	P
CGCGGTGGAACGGAGG_CGCAACATGTAAACTT_AAGAATTTCACCAATA_ATCCTAAGAGTTGAGG	P
CGCGGTGGAACGGAGG_CGCAACATGTAAACTT_AAGAATTTCACCAATA_GCTGATATAAGCACAC	P
CGCGGTGGAACGGAGG_CGCAACATGTAAACTT_AAGAATTTCACCAATA_TGGCTGTTAAGTGCTT	P
CGCGGTGGAACGGAGG_CGCAACATGTAAACTT_TGCCGCTCCACCGCTA_GGACTTAAATCACTCG	C
CGCGGTGGAACGGAGG_CGCAACATGTAAACTT_TGCCGCTCCACCGCTA_AGTGCCAGCCGAGGGC	P
CGCGGTGGAACGGAGG_CGCAACATGTAAACTT_TGCCGCTCCACCGCTA_TAGTTGTGGACACCAG	P
CGCGGTGGAACGGAGG_CGCAACATGTAAACTT_TCTACGAACGAGTAGC_AACTCAATCGTGCCAA	P
CGCGGTGGAACGGAGG_CGCAACATGTAAACTT_TCTACGAACGAGTAGC_GGCTCAACCCTTATAA	P
CGCGGTGGAACGGAGG_CGCAACATGTAAACTT_CTACGCGCTAGAAGCT_AATGCTCTAGTCGACT	P
TCTAGCGCGGCCGAAT_CTATGAGGTAGAAACA_CAGTGCTGCACACGAC_TACGTCCGGATCGACA	P
TCTAGCGCGGCCGAAT_CTATGAGGTAGAAACA_CAGTGCTGCACACGAC_TTGCTGGCGCCGAGGT	P
TCTAGCGCGGCCGAAT_CTATGAGGTAGAAACA_CAGTGCTGCACACGAC_ACACAAACTCGCAGGT	P
TCTAGCGCGGCCGAAT_CTATGAGGTAGAAACA_CAGTGCTGCACACGAC_GGGATTATAAAGTCCG	P
TCTAGCGCGGCCGAAT_CTATGAGGTAGAAACA_CAGTGCTGCACACGAC_GATACAATTTTGGATG	P
TCTAGCGCGGCCGAAT_CTATGAGGTAGAAACA_CAGTGCTGCACACGAC_CACTTGAAGAGCAGCC	P
TCTAGCGCGGCCGAAT_CTATGAGGTAGAAACA_CAGTGCTGCACACGAC_AATCGGGGACGTTTCG	P
TCTAGCGCGGCCGAAT_CTATGAGGTAGAAACA_CAGTGCTGCACACGAC_AACACATATTTGCTCA	P
TCTAGCGCGGCCGAAT_CTATGAGGTAGAAACA_CAGTGCTGCACACGAC_ACACGGTGATACTGAG	P;R(C)
TCTAGCGCGGCCGAAT_CTATGAGGTAGAAACA_CAGTGCTGCACACGAC_ACCCGCGGGCCATTTC	P
TCTAGCGCGGCCGAAT_CTATGAGGTAGAAACA_CAGTGCTGCACACGAC_GTGAGGCGTTGCTATA	P
TCTAGCGCGGCCGAAT_CTATGAGGTAGAAACA_CAGTGCTGCACACGAC_CCAGGCCACAGTCGTC	P
TCTAGCGCGGCCGAAT_CTATGAGGTAGAAACA_CAGTGCTGCACACGAC_TGCTTTCCAAAGTGTT	C
TCTAGCGCGGCCGAAT_CTATGAGGTAGAAACA_CAGTGCTGCACACGAC_GCCGGAGTGAGAGAAC	P
TCTAGCGCGGCCGAAT_CTATGAGGTAGAAACA_CAGTGCTGCACACGAC_ATAATGAACGCTGGCT	P
TCTAGCGCGGCCGAAT_CTATGAGGTAGAAACA_CAGTGCTGCACACGAC_GGAATCCCGCAGCATT	P
TCTAGCGCGGCCGAAT_CTATGAGGTAGAAACA_CAGTGCTGCACACGAC_AAATTGTTGACCCGTC	P
TCTAGCGCGGCCGAAT_CTATGAGGTAGAAACA_CAGTGCTGCACACGAC_AATCAAGAAAGTCCAA	P
TCTAGCGCGGCCGAAT_CTATGAGGTAGAAACA_CAGTGCTGCACACGAC_GCAGGCTTCGATATAC	P
TCTAGCGCGGCCGAAT_CTATGAGGTAGAAACA_CAGTGCTGCACACGAC_AACTCTGCTCTGCCGT	P
TCTAGCGCGGCCGAAT_CTATGAGGTAGAAACA_CAGTGCTGCACACGAC_AGATCAAGGGCTTCTA	P
TCTAGCGCGGCCGAAT_CTATGAGGTAGAAACA_CAGTGCTGCACACGAC_GCACTAAGAGGCATAT	P
TCTAGCGCGGCCGAAT_CTATGAGGTAGAAACA_CAGTGCTGCACACGAC_GAGACGTAGTGTAACT	P
TCTAGCGCGGCCGAAT_CTATGAGGTAGAAACA_CAGTGCTGCACACGAC_TCATAATTTCGTTGTC	P
TCTAGCGCGGCCGAAT_CTATGAGGTAGAAACA_CAGTGCTGCACACGAC_TGGACTGTTCCCAACG	P
TCTAGCGCGGCCGAAT_CTATGAGGTAGAAACA_GCCTACGAATACAACC_GCATGATCACCCAGCC	B;R(P)
TCTAGCGCGGCCGAAT_CTATGAGGTAGAAACA_GCCTACGAATACAACC_ATTGAAGTGGGCCGCT	P
TCTAGCGCGGCCGAAT_CTATGAGGTAGAAACA_GCCTACGAATACAACC_GGCGAGAATACGCTGT	P
TCTAGCGCGGCCGAAT_CTATGAGGTAGAAACA_GCCTACGAATACAACC_TCGCCGAAAGTTAGGT	P
TCTAGCGCGGCCGAAT_CTATGAGGTAGAAACA_GCCTACGAATACAACC_ACTCGGCACTTGGTTT	P
TCTAGCGCGGCCGAAT_CTATGAGGTAGAAACA_GCCTACGAATACAACC_ACTGTCGTTCGTCCTG	P
TCTAGCGCGGCCGAAT_CTATGAGGTAGAAACA_GCCTACGAATACAACC_GTAATCGTCGAATAAA	C
TCTAGCGCGGCCGAAT_CTATGAGGTAGAAACA_GCCTACGAATACAACC_GAGTACAAGGCGAAGT	C
TCTAGCGCGGCCGAAT_CTATGAGGTAGAAACA_GCCTACGAATACAACC_ATCGGTGTGCCCGCGC	P
TCTAGCGCGGCCGAAT_CTATGAGGTAGAAACA_GCCTACGAATACAACC_CGAACGCGGGTGGCAT	C
TCTAGCGCGGCCGAAT_CTATGAGGTAGAAACA_GCCTACGAATACAACC_CCGGCAACCAGCTGCC	C
TCTAGCGCGGCCGAAT_CTATGAGGTAGAAACA_GCCTACGAATACAACC_TGAAGCTAGTTAGCGA	C
TCTAGCGCGGCCGAAT_CTATGAGGTAGAAACA_GCCTACGAATACAACC_GCATTATCGGCGTGAG	P
TCTAGCGCGGCCGAAT_CTATGAGGTAGAAACA_GCCTACGAATACAACC_CGAGGGGTTCCTGACA	P
CGCGGTGGAACGGAGG_CGCAACATGTAAACTT_GCCGCTAGCTTGTGGC_TCTTGGACGGTTATCC	P
CGCGGTGGAACGGAGG_CGCAACATGTAAACTT_GCCGCTAGCTTGTGGC_CTGGGGAAGCATGTAT	P
CGCGGTGGAACGGAGG_CGCAACATGTAAACTT_AACGGCGGTGCTAGCC_CCTGCCTTATGGGCGC	P
CGCGGTGGAACGGAGG_CGCAACATGTAAACTT_AACGGCGGTGCTAGCC_GCTGAAACGGTCGTCA	P
AACGAGGCAGCGTTTT_CTCCTGGACACGTCTG_ACAATACCTTTACGCA_TTCAGTAGTGCAACAG	P
TGCGGCATAGTCCTCG_GTAGGTTATGCGGAAG_GTTAAATACGAAACCA_AGCGTTTACAAAACGT	P
CGAAGCGATGCGTGTA_CGTGTAACCCTCGCAA_CCATGCCAGCGACAGA_AAGTGCATCCGCGGCT	P
GCAACCCTGCAACTTC_CATACGGCAGTCAGTA_TCCGGCAAGGTCACCT_GGCTTTGGGGGGGGTT	P
GCAACCCTGCAACTTC_CATACGGCAGTCAGTA_TCCGGCAAGGTCACCT_AGGATTAGGTATACAT	P
