BC	flags
TGCTAAAAAGATCTAG_TGTGTTCAGGGGGCTG_TTATCGGACAGCGTGC_CCAGCTGGTCCGCCAG_CATTGGAATCCGGGTG	A
CGCGGTGGAACGGAGG_CGCAACATGTAAACTT_TCTACGAACGAGTAGC_ATGAAGGTCTACGTTC_AAGCACCAGCGGGTTT	C
TGCTAAAAAGATCTAG_TGTGTTCAGGGGGCTG_TAGAACCCGAGAGGGT_AGTCGGATGTACTCCC_CCATAGTAGTATGGCG	P
CGCGGTGGAACGGAGG_CGCAACATGTAAACTT_TGCCGCTCCACCGCTA_ATCGACTTCCTGTGCG_CTCAAATTGCACCGAT	P
TCTAGCGCGGCCGAAT_CTATGAGGTAGAAACA_CCGGAAAGAGTACGAC_CGGAATCATTATCGTC_ACCACACCGTGGGCCG	P
CCACGCGCGGTACGTC_TGCCACACACGACGAT_TTCACTACCAATCTCC_GATGTTGCCTGGCATA_CCAAAACCGGCTTACG	P
TCTAGCGCGGCCGAAT_CTATGAGGTAGAAACA_GATAGATATAGTAAGT_CCCGTGAAGGACATTT_TGAGACTGGCGCGGCA	B
CGCGGTGGAACGGAGG_CGCAACATGTAAACTT_AACGATGATACGTGGT_AGTATTATGCGACGCC_GTGTCTGGTGCCCCCG	P
CGCGGTGGAACGGAGG_CGCAACATGTAAACTT_AACGATGATACGTGGT_AGTATTATGCGACGCC_CGGCGCGGAACTGACA	P
CGCGGTGGAACGGAGG_CGCAACATGTAAACTT_AACGATGATACGTGGT_AGTATTATGCGACGCC_GCACAAAAAGGAATAG	P
CGCGGTGGAACGGAGG_CGCAACATGTAAACTT_AACGATGATACGTGGT_AGTATTATGCGACGCC_GTCAGATCCAGTGTTG	P
CGCGGTGGAACGGAGG_CGCAACATGTAAACTT_AACGATGATACGTGGT_AGTATTATGCGACGCC_TGCCAGTCATGGTGTC	P
CGCGGTGGAACGGAGG_CGCAACATGTAAACTT_AACGATGATACGTGGT_AGTATTATGCGACGCC_AAACGACCTCGGCATT	P
CGCGGTGGAACGGAGG_CGCAACATGTAAACTT_AACGATGATACGTGGT_AGTATTATGCGACGCC_TAATCCAGCATACGCG	P
CGCGGTGGAACGGAGG_CGCAACATGTAAACTT_AACGATGATACGTGGT_AGTATTATGCGACGCC_ACATCCCCGTACTCCA	P
CGCGGTGGAACGGAGG_CGCAACATGTAAACTT_AACGATGATACGTGGT_AGTATTATGCGACGCC_AGTGGGCCATTTAGAG	P
CGCGGTGGAACGGAGG_CGCAACATGTAAACTT_AACGATGATACGTGGT_AGTATTATGCGACGCC_CTACTCTAGGCGGACT	P
TGCTAAAAAGATCTAG_TGTGTTCAGGGGGCTG_TGAGGGGGCCGGTTTG_ATTGTCATGCGCTAAC_CAAATGCAACATATGC	P
CGCGGTGGAACGGAGG_CGCAACATGTAAACTT_CCTCTATCCCTGGGTA_TGCTAAACCCACACGC_GAGGTACTCCCGATGT	P
CCACGCGCGGTACGTC_TGCCACACACGACGAT_TATGTAGATCCAATGG_CCGTCGAACGCGTAAT_GTCAATATCACCGAAA	P
TGCTAAAAAGATCTAG_TGTGTTCAGGGGGCTG_TAAGCTTAACGAGCCG_CCGGTCTACTAGAAGT_ATGATGAGTAGCTGGT	P;R(B)
CGCGGTGGAACGGAGG_CGCAACATGTAAACTT_TGTACCGCAATTATAC_GTTGTGTGCGCTCTCC_TGGCCGCTTGCGTGTT	A
TGCTAAAAAGATCTAG_TGTGTTCAGGGGGCTG_TGAGGGGGCCGGTTTG_GGTCCTCAAGGGTTGC_ATGGGCCATCTCATAG	P
GTTTAATTTAATCGTG_TCCACTGCTTTAAGTG_TAACGAACACGTACGC_TAGCCTGAGACTGTAT_CCGGTAGGTGGGACCT	A
TCCATTGAGAACAACT_ACCTAGGTCGTGGGAG_TTGTCCCTAGTTGTGT_CATGGTTAAGGACTGT_AACAGTGTATAGAATC	P
CGCGGTGGAACGGAGG_CGCAACATGTAAACTT_GGCCCATAGGTCATCT_GACGGGATGCTGGTAA_AGCCTACTCAATGAGG	B
CGCGGTGGAACGGAGG_CGCAACATGTAAACTT_TCTACGAACGAGTAGC_CAGATGAATCGACCTT_CCTCAGATAGCGGCTG	P;R(C)
CGAAGCGATGCGTGTA_CGTGTAACCCTCGCAA_TCTGTGAGATGGAGTC_CGGAAGCGTTTACCTA_AGGCACAATTTCACAA	B
CGCGGTGGAACGGAGG_CGCAACATGTAAACTT_ACGGTCGGTCAGGTTT_TCAGGCAACAGGGAGT_CCAAGTAGTGAGCCCG	B;R(P)
TGCTAAAAAGATCTAG_TGTGTTCAGGGGGCTG_TATCAGCCGGTTAAAT_GGGTTAACGCGCTGTG_TATACCCCTACAGCAT	P;R(C)
TCCATTGAGAACAACT_ACCTAGGTCGTGGGAG_AACGTTAAGTGTTCAT_GTCATTCTAAGGCCGG_GTAGATACGTGGCCCA	P;R(B)
TCCATTGAGAACAACT_ACCTAGGTCGTGGGAG_AACGTTAAGTGTTCAT_GTCATTCTAAGGCCGG_CCACGAGGGAGCTTTC	P;R(B)
TCCATTGAGAACAACT_ACCTAGGTCGTGGGAG_AACGTTAAGTGTTCAT_GTCATTCTAAGGCCGG_AGGGCCTCTACGTATT	P;R(B)
TCCATTGAGAACAACT_ACCTAGGTCGTGGGAG_AACGTTAAGTGTTCAT_GTCATTCTAAGGCCGG_GCTCTGGATTTGAGAC	P;R(B)
TCCATTGAGAACAACT_ACCTAGGTCGTGGGAG_AACGTTAAGTGTTCAT_GTCATTCTAAGGCCGG_CTCACGTATATCGGTA	P;R(B)
CCACGCGCGGTACGTC_TGCCACACACGACGAT_TATGTAGATCCAATGG_AGACACATGACATCCA_CTGCTTAGACCGGTCG	C
TCTAGCGCGGCCGAAT_CTATGAGGTAGAAACA_TAAGTGCGTAAGTGAG_TCCAGAGCAAATGTAT_TTATCGGCCTCCCCAG	P
TCTAGCGCGGCCGAAT_CTATGAGGTAGAAACA_GATAGATATAGTAAGT_CAACGAAAAATGCGAT_GGCGAGCGACTTAGAC	C
TCTAGCGCGGCCGAAT_CTATGAGGTAGAAACA_CCGGAAAGAGTACGAC_CCAACGAAGTGATTCT_TAGCACCCTAAGCAGA	P
TCTAGCGCGGCCGAAT_CTATGAGGTAGAAACA_CCGGAAAGAGTACGAC_CCAACGAAGTGATTCT_GAGGGTTCTCTTAATT	C;R(B)
GTGCGGACCCCGTGAT_ATCCAAAATCTGTGAC_TAGATTCATAGCTGGC_TTGATTCCTGTTTTGT_CGGTACGATTTGGAGC	P
CGAAGCGATGCGTGTA_CGTGTAACCCTCGCAA_TCTGTGAGATGGAGTC_AAGACTACACACGCTC_CGAACCGACTTACTTA	B
TCCATTGAGAACAACT_TGCACACCCATGAGTA_GGTTGCAAGCATAGAA_GCTGTCGCGTTTCGTT_TTGCGAGGCCCGGAAT	C
TCTAGCGCGGCCGAAT_CTATGAGGTAGAAACA_GATAGATATAGTAAGT_ACATCCACGGGTTCGG_TCCGTCAATCAGGTCA	P
TCTAGCGCGGCCGAAT_CTATGAGGTAGAAACA_CCGGAAAGAGTACGAC_ATGCCGAGAACGTAGT_GAAGGCCCGAATCACA	P
TCTAGCGCGGCCGAAT_CTATGAGGTAGAAACA_CCGGAAAGAGTACGAC_ATGCCGAGAACGTAGT_TATGGTTGCGTAGGTC	P
TCTAGCGCGGCCGAAT_CTATGAGGTAGAAACA_CCGGAAAGAGTACGAC_ATGCCGAGAACGTAGT_TGATGTGAAGGTACAA	P
TCTAGCGCGGCCGAAT_CTATGAGGTAGAAACA_CCGGAAAGAGTACGAC_ATGCCGAGAACGTAGT_GGAGAGGACGAAGCTT	P
TCTAGCGCGGCCGAAT_CTATGAGGTAGAAACA_CCGGAAAGAGTACGAC_ATGCCGAGAACGTAGT_GGATGTCTAGACTCCG	P
TCTAGCGCGGCCGAAT_CTATGAGGTAGAAACA_CCGGAAAGAGTACGAC_ATGCCGAGAACGTAGT_TGCACGCAGCTGCCTT	P
TCTAGCGCGGCCGAAT_CTATGAGGTAGAAACA_CCGGAAAGAGTACGAC_ATGCCGAGAACGTAGT_TAATGGGAGGCTAGGA	P
TCTAGCGCGGCCGAAT_CTATGAGGTAGAAACA_CCGGAAAGAGTACGAC_ATGCCGAGAACGTAGT_TGTGAATCCGGGTGCA	P
TCTAGCGCGGCCGAAT_CTATGAGGTAGAAACA_CCGGAAAGAGTACGAC_ATGCCGAGAACGTAGT_GTGAAGATAGTCAACG	P
TCTAGCGCGGCCGAAT_CTATGAGGTAGAAACA_CCGGAAAGAGTACGAC_GGCGTCGGGTTAGTGT_GAGAATGCTTAAATAG	A
CGCGGTGGAACGGAGG_CGCAACATGTAAACTT_TGCCGCTCCACCGCTA_GGACTTAAATCACTCG_CGTGAACATGAAATTT	A
TCTAGCGCGGCCGAAT_CTATGAGGTAGAAACA_GAAGGCGGTTTGGCAT_CATTGCGGCGATTCCC_TGGGACGGGTTCAATT	P
TCTAGCGCGGCCGAAT_CTATGAGGTAGAAACA_GAAGGCGGTTTGGCAT_CATTGCGGCGATTCCC_CTCTGGTCACTTGACC	P
TCTAGCGCGGCCGAAT_CTATGAGGTAGAAACA_GAAGGCGGTTTGGCAT_CATTGCGGCGATTCCC_GATCTGGTCTGGCTAG	P
TCTAGCGCGGCCGAAT_CTATGAGGTAGAAACA_GAAGGCGGTTTGGCAT_CTCGGCAATTCCCCGG_CGGCGTTGGGGGGACT	P
TCTAGCGCGGCCGAAT_CTATGAGGTAGAAACA_GATAGATATAGTAAGT_GTACCGCGTGTGCCTT_TTGCCCGAATCGTGAA	P
TGCTAAAAAGATCTAG_TGTGTTCAGGGGGCTG_TAAGCTTAACGAGCCG_ATCCAACTTGAGGATA_AGGGCAGGCTCTCCCG	P;R(C)
TCTAGCGCGGCCGAAT_CTATGAGGTAGAAACA_CCGGAAAGAGTACGAC_TAGGGAGTGAACCGTT_GAATGGGAAACAGTCG	P
TCTAGCGCGGCCGAAT_CTATGAGGTAGAAACA_CCGGAAAGAGTACGAC_TAGGGAGTGAACCGTT_CTCGTGAAAAGCGTCG	P
TCTAGCGCGGCCGAAT_CTATGAGGTAGAAACA_CCGGAAAGAGTACGAC_TAGGGAGTGAACCGTT_TCGATGTGACTATTCC	P
TCTAGCGCGGCCGAAT_CTATGAGGTAGAAACA_CCGGAAAGAGTACGAC_TAGGGAGTGAACCGTT_TGCCTAGGGTAATGAT	P
TCTAGCGCGGCCGAAT_CTATGAGGTAGAAACA_CCGGAAAGAGTACGAC_TAGGGAGTGAACCGTT_AATATCGACCGATAAG	P
TCTAGCGCGGCCGAAT_CTATGAGGTAGAAACA_CCGGAAAGAGTACGAC_TAGGGAGTGAACCGTT_CCGGCAGTACATTATG	P
TCTAGCGCGGCCGAAT_CTATGAGGTAGAAACA_CCGGAAAGAGTACGAC_TAGGGAGTGAACCGTT_GCGCAATTTAGGGGAA	P
TCTAGCGCGGCCGAAT_CTATGAGGTAGAAACA_CCGGAAAGAGTACGAC_TAGGGAGTGAACCGTT_CAGTTTCAGGAGCCCT	P
TCTAGCGCGGCCGAAT_CTATGAGGTAGAAACA_CCGGAAAGAGTACGAC_TAGGGAGTGAACCGTT_TTGGTATATGCGGTGT	P
TCTAGCGCGGCCGAAT_CTATGAGGTAGAAACA_CCGGAAAGAGTACGAC_TAGGGAGTGAACCGTT_TATGACCAGAATCCGT	P
TCTAGCGCGGCCGAAT_CTATGAGGTAGAAACA_CCGGAAAGAGTACGAC_TAGGGAGTGAACCGTT_AATCATCCGTCGCAGT	P
TCTAGCGCGGCCGAAT_CTATGAGGTAGAAACA_CCGGAAAGAGTACGAC_TAGGGAGTGAACCGTT_ACTAGCGAACATGTGC	P
TCTAGCGCGGCCGAAT_CTATGAGGTAGAAACA_CCGGAAAGAGTACGAC_TAGGGAGTGAACCGTT_TCGTTTGAGAAAAAAT	P
TCTAGCGCGGCCGAAT_CTATGAGGTAGAAACA_CCGGAAAGAGTACGAC_TAGGGAGTGAACCGTT_AGGGGCTGGACCTTAT	P
TCTAGCGCGGCCGAAT_CTATGAGGTAGAAACA_CCGGAAAGAGTACGAC_TAGGGAGTGAACCGTT_TACCAGCTCATCTGGG	P
TCTAGCGCGGCCGAAT_CTATGAGGTAGAAACA_CCGGAAAGAGTACGAC_TAGGGAGTGAACCGTT_CAGTAAGCATCTGTGG	P
TCTAGCGCGGCCGAAT_CTATGAGGTAGAAACA_GAAGGCGGTTTGGCAT_AACGGAATAGAGTATG_TTGTGGGCAGAGTGCA	P
TCTAGCGCGGCCGAAT_CTATGAGGTAGAAACA_GAAGGCGGTTTGGCAT_AACGGAATAGAGTATG_TGGCATCCTCGACGTA	P
TCTAGCGCGGCCGAAT_CTATGAGGTAGAAACA_CAGTGCTGCACACGAC_ACCCGCGGGCCATTTC_ACTGTGAGTACCCGTC	P
TCTAGCGCGGCCGAAT_CTATGAGGTAGAAACA_CCGGAAAGAGTACGAC_CGTTAGTCCTTTTGAT_TGGAGGGCAGGACTCT	P
TCTAGCGCGGCCGAAT_CTATGAGGTAGAAACA_CCGGAAAGAGTACGAC_CGTTAGTCCTTTTGAT_ACGACGGTACTGTTGC	P
TCTAGCGCGGCCGAAT_CTATGAGGTAGAAACA_CCGGAAAGAGTACGAC_CGTTAGTCCTTTTGAT_TCATTTGAGCTGAGTT	P
TCTAGCGCGGCCGAAT_CTATGAGGTAGAAACA_CCGGAAAGAGTACGAC_CGTTAGTCCTTTTGAT_AGGTGTGAGAATTGCG	P
TCTAGCGCGGCCGAAT_CTATGAGGTAGAAACA_CAGTGCTGCACACGAC_CCAGGCCACAGTCGTC_AGACCAGCTCGCCTAG	P
TCTAGCGCGGCCGAAT_CTATGAGGTAGAAACA_GAAGGCGGTTTGGCAT_AAAGCCTCTGAGACTA_CATCAACCGAGTTATC	P
TCTAGCGCGGCCGAAT_CTATGAGGTAGAAACA_GAAGGCGGTTTGGCAT_AAAGCCTCTGAGACTA_AATGTAGAGGCCAAAT	P
TCTAGCGCGGCCGAAT_CTATGAGGTAGAAACA_CAGTGCTGCACACGAC_TACGTCCGGATCGACA_AGACAGCCGTGGGTAA	P
TCTAGCGCGGCCGAAT_CTATGAGGTAGAAACA_CCGGAAAGAGTACGAC_CGAATCAAACGTCCTC_TCGGGAATTAGGAGTT	P
TCTAGCGCGGCCGAAT_CTATGAGGTAGAAACA_CGCTTAGTACCCGGAT_TATACCTCACCGCGGG_GGGTCCCGTTCGGAAA	P
TAAATCTTGTCAGTCA_TCTGGACCCGGTAGAG_AATAAGCAAAGTCAGT_AAGGACATACTGTCCC_GACCTCGTTGCCGTAG	P
TAAATCTTGTCAGTCA_TCTGGACCCGGTAGAG_AATAAGCAAAGTCAGT_AAGGACATACTGTCCC_ACGTTGTCAAGCTTGC	P
TAAATCTTGTCAGTCA_TCTGGACCCGGTAGAG_AATAAGCAAAGTCAGT_AAGGACATACTGTCCC_GTCGTTCTCAGCTCCG	P
TCTAGCGCGGCCGAAT_CTATGAGGTAGAAACA_GATAGATATAGTAAGT_CCCGTGAAGGACATTT_CCTGCCGAACCTACCT	C
TCTAGCGCGGCCGAAT_CTATGAGGTAGAAACA_GATAGATATAGTAAGT_CCCGTGAAGGACATTT_CGATTTGTGGTAAGGC	P
TCTAGCGCGGCCGAAT_CTATGAGGTAGAAACA_GATAGATATAGTAAGT_CCCGTGAAGGACATTT_TTCTGCACAAGGGCCG	P
TCTAGCGCGGCCGAAT_CTATGAGGTAGAAACA_GATAGATATAGTAAGT_CCCGTGAAGGACATTT_GTCCCCTGCTTCACGC	P
TCTAGCGCGGCCGAAT_CTATGAGGTAGAAACA_TAAGTGCGTAAGTGAG_AGCCGCTTGCTGCTGC_GTGCACATACGCTCGC	P
TCTAGCGCGGCCGAAT_CTATGAGGTAGAAACA_CCGGAAAGAGTACGAC_GCTGACGCTGTCGATC_AACTGTCACAAGCTAG	P
TCTAGCGCGGCCGAAT_CTATGAGGTAGAAACA_CCGGAAAGAGTACGAC_GCTGACGCTGTCGATC_GCTGGCCTTTCCCTGT	P
TCTAGCGCGGCCGAAT_CTATGAGGTAGAAACA_CCGGAAAGAGTACGAC_GCTGACGCTGTCGATC_ACACAGTGTGGGGACA	P
TCTAGCGCGGCCGAAT_CTATGAGGTAGAAACA_CCGGAAAGAGTACGAC_GCTGACGCTGTCGATC_TTAGTAGGCGTGGAAG	P
TCTAGCGCGGCCGAAT_CTATGAGGTAGAAACA_CCGGAAAGAGTACGAC_GCTGACGCTGTCGATC_TCGAACGCCCTCGAAC	P
TCTAGCGCGGCCGAAT_CTATGAGGTAGAAACA_CAGTGCTGCACACGAC_GCACTAAGAGGCATAT_AGAAATGCAGTATCGG	P
TCTAGCGCGGCCGAAT_CTATGAGGTAGAAACA_CAGTGCTGCACACGAC_GCACTAAGAGGCATAT_ACTTGTAAGGCCCTAT	P
TCTAGCGCGGCCGAAT_CTATGAGGTAGAAACA_CCGGAAAGAGTACGAC_GGGTTCGCAGGGTCTG_TTCGTGCAAAATCTGG	P
TCTAGCGCGGCCGAAT_CTATGAGGTAGAAACA_GATAGATATAGTAAGT_AGTGTTGAGAGGCTGA_GGACTTGGAGCTAGTG	P
TGCTAAAAAGATCTAG_TGTGTTCAGGGGGCTG_TGAGGGGGCCGGTTTG_ATTGTCATGCGCTAAC_ATAAGTTAAATTGAGG	P
TCTAGCGCGGCCGAAT_CTATGAGGTAGAAACA_CGCTTAGTACCCGGAT_AGTCGTTGCGCAAGCG_ACCTCTGTCCACCTCG	P
TCTAGCGCGGCCGAAT_CTATGAGGTAGAAACA_CGCTTAGTACCCGGAT_AGTCGTTGCGCAAGCG_TTAGCAGACTGAAATG	P
TCTAGCGCGGCCGAAT_CTATGAGGTAGAAACA_GAAGGCGGTTTGGCAT_TCAACAGGGGGTAGAT_CGGCTTCAAAGTGACC	P
TCTAGCGCGGCCGAAT_CTATGAGGTAGAAACA_GATGTGAGCATTCTAC_GGTCTACCTCAGAAGT_GATGCCGGTCAGGTGC	P
TCTAGCGCGGCCGAAT_CTATGAGGTAGAAACA_GATGTGAGCATTCTAC_GGTCTACCTCAGAAGT_GCGACTCTCGGGTGAA	P
TCTAGCGCGGCCGAAT_CTATGAGGTAGAAACA_GCCTACGAATACAACC_GTAATCGTCGAATAAA_ATACTCACACTGCTAC	A
TCTAGCGCGGCCGAAT_CTATGAGGTAGAAACA_CAGTGCTGCACACGAC_GTGAGGCGTTGCTATA_TTCAGCGTACAGAAGT	P
TCTAGCGCGGCCGAAT_CTATGAGGTAGAAACA_TAAGTGCGTAAGTGAG_CTGGTGTGTGGTGCGG_CCTTGGACGCAGTGCA	P
TCTAGCGCGGCCGAAT_CTATGAGGTAGAAACA_TAAGTGCGTAAGTGAG_CTGGTGTGTGGTGCGG_CTCCTGATACTCGACG	P
TCTAGCGCGGCCGAAT_CTATGAGGTAGAAACA_CCGGAAAGAGTACGAC_AGGTCCCCGACTTTAA_CCAGCTCCTGAATGCC	P
TCTAGCGCGGCCGAAT_CTATGAGGTAGAAACA_CCGGAAAGAGTACGAC_AGGTCCCCGACTTTAA_GGTGCGGTGTTAAGCC	P
TCTAGCGCGGCCGAAT_CTATGAGGTAGAAACA_CCGGAAAGAGTACGAC_AGGTCCCCGACTTTAA_AGCTACAGTCTGTCGC	C;R(P)
TCTAGCGCGGCCGAAT_CTATGAGGTAGAAACA_CCGGAAAGAGTACGAC_AGGTCCCCGACTTTAA_CTAGGACAACTCAAAG	P
TCTAGCGCGGCCGAAT_CTATGAGGTAGAAACA_CCGGAAAGAGTACGAC_AGGTCCCCGACTTTAA_ACTGTCTTGCGTAGAA	P
TCTAGCGCGGCCGAAT_CTATGAGGTAGAAACA_CCGGAAAGAGTACGAC_AGGTCCCCGACTTTAA_ATGCGGATGTCATAAC	P
TCTAGCGCGGCCGAAT_CTATGAGGTAGAAACA_CCGGAAAGAGTACGAC_AGGTCCCCGACTTTAA_AACCGAAATCGATAGT	P
TCTAGCGCGGCCGAAT_CTATGAGGTAGAAACA_GAAGGCGGTTTGGCAT_GTTGCCACTACGGGCA_AATAACCTAAACCATG	P
TCTAGCGCGGCCGAAT_CTATGAGGTAGAAACA_CCGGAAAGAGTACGAC_TCAAGGGGCGCAGCCG_AAACTATGATGGAATC	P
TCTAGCGCGGCCGAAT_CTATGAGGTAGAAACA_CCGGAAAGAGTACGAC_TCAAGGGGCGCAGCCG_TCTCTGTAGGATAGCC	P
TCTAGCGCGGCCGAAT_CTATGAGGTAGAAACA_CCGGAAAGAGTACGAC_TCAAGGGGCGCAGCCG_ACAGATACACACGGAA	P
TCTAGCGCGGCCGAAT_CTATGAGGTAGAAACA_CCGGAAAGAGTACGAC_TCAAGGGGCGCAGCCG_TAGCAATTCTGCCTGT	P
TCTAGCGCGGCCGAAT_CTATGAGGTAGAAACA_CCGGAAAGAGTACGAC_TCAAGGGGCGCAGCCG_ATCACGGACTGCGAGT	P
TCTAGCGCGGCCGAAT_CTATGAGGTAGAAACA_CCGGAAAGAGTACGAC_TCAAGGGGCGCAGCCG_TCAAAAAGAGGCATCA	P
TCTAGCGCGGCCGAAT_CTATGAGGTAGAAACA_CCGGAAAGAGTACGAC_TCAAGGGGCGCAGCCG_CAACTGAAGACCAAGG	P
TCTAGCGCGGCCGAAT_CTATGAGGTAGAAACA_CCGGAAAGAGTACGAC_TCAAGGGGCGCAGCCG_TCCATCTAGGGTGCGA	P
TCTAGCGCGGCCGAAT_CTATGAGGTAGAAACA_CCGGAAAGAGTACGAC_TCAAGGGGCGCAGCCG_GGACTGCCAATGCCTG	P
TCTAGCGCGGCCGAAT_CTATGAGGTAGAAACA_GCCTACGAATACAACC_GCATTATCGGCGTGAG_TTCTTGTACAAGACCA	P
TCTAGCGCGGCCGAAT_CTATGAGGTAGAAACA_CAATAATATGAGCCAA_ACGTGTCGCGTTTCAT_TTGCAGGCTGTATTAC	P
TCTAGCGCGGCCGAAT_CTATGAGGTAGAAACA_GAAGGCGGTTTGGCAT_AAAATGGGATAGGTCC_GCCCTAGTCCTTGAGC	A;R(B);R(P)
TCTAGCGCGGCCGAAT_CTATGAGGTAGAAACA_GAAGGCGGTTTGGCAT_AAAATGGGATAGGTCC_GTAGTAGAGGGCGACG	P;R(A)
TCTAGCGCGGCCGAAT_CTATGAGGTAGAAACA_TTAAGAGTAAGAGAGT_TTCCCTATCCGAGGCC_ATGACTTCCCAAACCT	P
TCTAGCGCGGCCGAAT_CTATGAGGTAGAAACA_GAAGGCGGTTTGGCAT_TGCTGCATTGTGGGAG_TCCAGTAGTGCGTCCG	A
TCTAGCGCGGCCGAAT_CTATGAGGTAGAAACA_GAAGGCGGTTTGGCAT_TGCTGCATTGTGGGAG_TGGGGTGCAGTTACAA	P;R(A)
TCTAGCGCGGCCGAAT_CTATGAGGTAGAAACA_GAAGGCGGTTTGGCAT_TGCTGCATTGTGGGAG_ACGGGTAGATCGACCA	C
TCTAGCGCGGCCGAAT_CTATGAGGTAGAAACA_GAAGGCGGTTTGGCAT_TGCTGCATTGTGGGAG_TGCACACTACCACAGT	P
TCTAGCGCGGCCGAAT_CTATGAGGTAGAAACA_GAAGGCGGTTTGGCAT_AGCTGATATGCCATGT_TGCGGACTGGTTCTTT	P
TCTAGCGCGGCCGAAT_CTATGAGGTAGAAACA_GAAGGCGGTTTGGCAT_AGCTGATATGCCATGT_CCAGGAATTCTTCGCT	P
TCTAGCGCGGCCGAAT_CTATGAGGTAGAAACA_CCGGAAAGAGTACGAC_CCTCCTGTTCATTACC_TTTATGCCAACGCCGT	P
TCTAGCGCGGCCGAAT_CTATGAGGTAGAAACA_CCGGAAAGAGTACGAC_CCTCCTGTTCATTACC_CTACCCTGAGGACGGC	P
TCTAGCGCGGCCGAAT_CTATGAGGTAGAAACA_CCGGAAAGAGTACGAC_CCTCCTGTTCATTACC_GGGCAGTTGGAACCAC	P
TCTAGCGCGGCCGAAT_CTATGAGGTAGAAACA_CCGGAAAGAGTACGAC_CCTCCTGTTCATTACC_ATCTTTCAGCGGCTGC	P
TCTAGCGCGGCCGAAT_CTATGAGGTAGAAACA_CCGGAAAGAGTACGAC_CCTCCTGTTCATTACC_ATAACGAGCTCGATTG	P
TCTAGCGCGGCCGAAT_CTATGAGGTAGAAACA_CCGGAAAGAGTACGAC_CCTCCTGTTCATTACC_GCGTATTGTCGAAGAT	P
CGCGGTGGAACGGAGG_CGCAACATGTAAACTT_CCCACTAGGATTTCTC_ACGTATTGGCGCAGGC_CACAGCATTTTGGGAG	C
TCTAGCGCGGCCGAAT_CTATGAGGTAGAAACA_CCGGAAAGAGTACGAC_TCCGGGCGACTTTGGC_ACAGTGGTACGTTCAA	P
TCTAGCGCGGCCGAAT_CTATGAGGTAGAAACA_CCGGAAAGAGTACGAC_TCCGGGCGACTTTGGC_CTCCTTCACAAGCTTA	P
TCTAGCGCGGCCGAAT_CTATGAGGTAGAAACA_CCGGAAAGAGTACGAC_TCCGGGCGACTTTGGC_TGACTACTCCGGCCTT	P
TCTAGCGCGGCCGAAT_CTATGAGGTAGAAACA_CCGGAAAGAGTACGAC_TCCGGGCGACTTTGGC_AGATCCTCCATCAATG	P
TCTAGCGCGGCCGAAT_CTATGAGGTAGAAACA_CCGGAAAGAGTACGAC_TCCGGGCGACTTTGGC_TGTAGCGGCCCTCTAC	P
TCTAGCGCGGCCGAAT_CTATGAGGTAGAAACA_CCGGAAAGAGTACGAC_TCCGGGCGACTTTGGC_ATCGACGATCAACGGC	P
TCTAGCGCGGCCGAAT_CTATGAGGTAGAAACA_CCGGAAAGAGTACGAC_TCCGGGCGACTTTGGC_TCAAGATACAAGTTCC	P
TCTAGCGCGGCCGAAT_CTATGAGGTAGAAACA_GAAGGCGGTTTGGCAT_GAATGGAGATAGCATA_ATCTCTAGCCAATGTC	P
GTTTAATTTAATCGTG_TCCACTGCTTTAAGTG_TAACGAACACGTACGC_TAGCCTGAGACTGTAT_AGAATACTGTAACCTC	P
TCTAGCGCGGCCGAAT_CTATGAGGTAGAAACA_GATAGATATAGTAAGT_TTGGCCCCGATTCGTC_TGCATGAATGTACGCT	P
TCTAGCGCGGCCGAAT_CTATGAGGTAGAAACA_CAGTGCTGCACACGAC_TGCTTTCCAAAGTGTT_TCTGGCCCGGGATTAT	C
TCTAGCGCGGCCGAAT_CTATGAGGTAGAAACA_GCCTACGAATACAACC_CCGGCAACCAGCTGCC_AGAATAGGTCAGGGTT	A
TCTAGCGCGGCCGAAT_CTATGAGGTAGAAACA_CAGTGCTGCACACGAC_AATCAAGAAAGTCCAA_AGTCGTCCTTCCGCTC	P
TCTAGCGCGGCCGAAT_CTATGAGGTAGAAACA_GCCTACGAATACAACC_ACTGTCGTTCGTCCTG_GAGTTAGATCCTAGAC	C;R(P)
TCTAGCGCGGCCGAAT_CTATGAGGTAGAAACA_TAAGTGCGTAAGTGAG_TCAGGTCAAAAGCCAT_AGACGTCCGATCTATG	A
TCTAGCGCGGCCGAAT_CTATGAGGTAGAAACA_CCGGAAAGAGTACGAC_GGACACGTTTCGGCCC_CCGTGTTTGGAAACAT	P
TCTAGCGCGGCCGAAT_CTATGAGGTAGAAACA_CCGGAAAGAGTACGAC_GGACACGTTTCGGCCC_ATGATACTTGGTCCCC	P
TCTAGCGCGGCCGAAT_CTATGAGGTAGAAACA_CCGGAAAGAGTACGAC_GGACACGTTTCGGCCC_CGAATTAGGTCGGGGT	P
TCTAGCGCGGCCGAAT_CTATGAGGTAGAAACA_CCGGAAAGAGTACGAC_GGACACGTTTCGGCCC_TTATCGCGCCGGGATT	P
TCTAGCGCGGCCGAAT_CTATGAGGTAGAAACA_CGCTTAGTACCCGGAT_GACACAGAACTAGTTA_TAACAGGGACGCTGGA	P;R(A)
TCTAGCGCGGCCGAAT_CTATGAGGTAGAAACA_CAGGCACTCACGTTAC_GTCAGAATTCGGAAAA_ATGAGATATGGGTAGT	P
TCTAGCGCGGCCGAAT_CTATGAGGTAGAAACA_CAGGCACTCACGTTAC_GTCAGAATTCGGAAAA_CAGTTGGCAACGCAAA	P
TCTAGCGCGGCCGAAT_CTATGAGGTAGAAACA_CAGGCACTCACGTTAC_GTCAGAATTCGGAAAA_TCCGAGATCTCTAAGT	P
TCTAGCGCGGCCGAAT_CTATGAGGTAGAAACA_CAGGCACTCACGTTAC_GTCAGAATTCGGAAAA_ACAGCCAACTATATTA	P
TCTAGCGCGGCCGAAT_CTATGAGGTAGAAACA_CAGGCACTCACGTTAC_GTCAGAATTCGGAAAA_GTTCTCACCTGCTGAC	P
TCTAGCGCGGCCGAAT_CTATGAGGTAGAAACA_GAAGGCGGTTTGGCAT_CCGCCTCGTAACCAGC_CTGCTGAGATGTGAAA	P
TCTAGCGCGGCCGAAT_CTATGAGGTAGAAACA_GCCTACGAATACAACC_ATCGGTGTGCCCGCGC_GCAAGAAGGTGCATCG	P
TCTAGCGCGGCCGAAT_CTATGAGGTAGAAACA_GCCTACGAATACAACC_ATCGGTGTGCCCGCGC_ATTGGAGATTGTTGCC	P
TCTAGCGCGGCCGAAT_CTATGAGGTAGAAACA_GCCTACGAATACAACC_ATCGGTGTGCCCGCGC_TGTACGTGCCCGTGTA	P
TCTAGCGCGGCCGAAT_CTATGAGGTAGAAACA_GCCTACGAATACAACC_ATCGGTGTGCCCGCGC_TCGCAAAAGAGCCCAG	A;R(P)
ACTTCGGGTGTCGTAG_GAACAGTCGAAGAGTA_TGGACATAATGATAGT_ACGGGCTTATCCGGAC_AATACACGGCTCCCAA	P
ACTTCGGGTGTCGTAG_GAACAGTCGAAGAGTA_TGGACATAATGATAGT_ACGGGCTTATCCGGAC_TGGACCGACAACGCTA	P
ACTTCGGGTGTCGTAG_GAACAGTCGAAGAGTA_TGGACATAATGATAGT_ACGGGCTTATCCGGAC_CTAGTTGGTTCCCGAG	P
ACTTCGGGTGTCGTAG_GAACAGTCGAAGAGTA_TGGACATAATGATAGT_ACGGGCTTATCCGGAC_CGTGTGTCGACAGGGA	P
ACTTCGGGTGTCGTAG_GAACAGTCGAAGAGTA_TGGACATAATGATAGT_ACGGGCTTATCCGGAC_AGGTCCTATCGGCGCA	P
ACTTCGGGTGTCGTAG_GAACAGTCGAAGAGTA_TGGACATAATGATAGT_ACGGGCTTATCCGGAC_GCCTATGGAGTTCAGA	P
TCTAGCGCGGCCGAAT_CTATGAGGTAGAAACA_CCGGAAAGAGTACGAC_CAACCTTTTTGCGAGA_GTACGAAAGGCCTTAG	P
TCTAGCGCGGCCGAAT_CTATGAGGTAGAAACA_TAAGTGCGTAAGTGAG_CCATAACGCCGGGGCA_CGGCATGTCATCTGAT	P
TCTAGCGCGGCCGAAT_CTATGAGGTAGAAACA_GAAGGCGGTTTGGCAT_TGGGGATTACGGGCTT_TGCTACAAAACGCGCT	P
TCTAGCGCGGCCGAAT_CTATGAGGTAGAAACA_GAAGGCGGTTTGGCAT_TGGGGATTACGGGCTT_CAACAGGAATCAGCCC	P
TCTAGCGCGGCCGAAT_CTATGAGGTAGAAACA_GAAGGCGGTTTGGCAT_TGGGGATTACGGGCTT_GTCTACGGCATCGGTC	P
TCTAGCGCGGCCGAAT_CTATGAGGTAGAAACA_CCGGAAAGAGTACGAC_CGCTGCTGGACTGTCT_TAGACCGATATCAATG	P
TCTAGCGCGGCCGAAT_CTATGAGGTAGAAACA_CCGGAAAGAGTACGAC_CGCTGCTGGACTGTCT_CTACTGTCATCGCAAA	P
TCTAGCGCGGCCGAAT_CTATGAGGTAGAAACA_CCGGAAAGAGTACGAC_CGCTGCTGGACTGTCT_AATCAAGGAAGCGCGA	P
TCTAGCGCGGCCGAAT_CTATGAGGTAGAAACA_CCGGAAAGAGTACGAC_CGCTGCTGGACTGTCT_TTGGACCGTGTACAGG	P
TCTAGCGCGGCCGAAT_CTATGAGGTAGAAACA_CCGGAAAGAGTACGAC_CGCTGCTGGACTGTCT_CCAAGTTCTCAAGAGC	P
TCTAGCGCGGCCGAAT_CTATGAGGTAGAAACA_CCGGAAAGAGTACGAC_CGCTGCTGGACTGTCT_CGGGGTGTAAGCATAT	C
TCTAGCGCGGCCGAAT_CTATGAGGTAGAAACA_CCGGAAAGAGTACGAC_CGCTGCTGGACTGTCT_CCCACAATCTGTCAAC	P
TCTAGCGCGGCCGAAT_CTATGAGGTAGAAACA_CAGTGCTGCACACGAC_AACACATATTTGCTCA_GATAAGGAGTTGTCGT	P
TCTAGCGCGGCCGAAT_CTATGAGGTAGAAACA_CAGTGCTGCACACGAC_AACACATATTTGCTCA_CCCATCGATTCGCATA	P
TCTAGCGCGGCCGAAT_CTATGAGGTAGAAACA_GTACAGACTGCATGCT_GTCGCGCAGGCGAATT_GGTCTCGCTAAGGATG	P
TCTAGCGCGGCCGAAT_CTATGAGGTAGAAACA_TTAAGAGTAAGAGAGT_ATCAGTGTAAAGCCCA_CGACCCAGAGATAACT	P
TCTAGCGCGGCCGAAT_CTATGAGGTAGAAACA_TTAAGAGTAAGAGAGT_ATCAGTGTAAAGCCCA_ACTGTATGCAGCGATC	A
TCTAGCGCGGCCGAAT_CTATGAGGTAGAAACA_CAGTGCTGCACACGAC_GAGACGTAGTGTAACT_ATGCGCAAAATGTGTA	P
TCTAGCGCGGCCGAAT_CTATGAGGTAGAAACA_TAAGTGCGTAAGTGAG_TGCCGTAATGGGGAAG_GAGACGGATGCCGCCG	P
TCTAGCGCGGCCGAAT_CTATGAGGTAGAAACA_TAAGTGCGTAAGTGAG_GCAATCAAGTCCAACG_TGCTTTACGCGCTCAG	P
TCTAGCGCGGCCGAAT_CTATGAGGTAGAAACA_CCGGAAAGAGTACGAC_TGCGTAGAATATTGCG_AGACCAGGAAGCCTCA	P
TCTAGCGCGGCCGAAT_CTATGAGGTAGAAACA_CCGGAAAGAGTACGAC_TGCGTAGAATATTGCG_GCCGGATGACTCGGAC	P
TCTAGCGCGGCCGAAT_CTATGAGGTAGAAACA_CCGGAAAGAGTACGAC_TGCGTAGAATATTGCG_CATGGACATCTCAAAA	P
TCTAGCGCGGCCGAAT_CTATGAGGTAGAAACA_CCGGAAAGAGTACGAC_TGCGTAGAATATTGCG_CGGCCAGCGCATCTTC	P
TCTAGCGCGGCCGAAT_CTATGAGGTAGAAACA_CCGGAAAGAGTACGAC_TGCGTAGAATATTGCG_GCGCCACTCTGTGTTC	P
TCTAGCGCGGCCGAAT_CTATGAGGTAGAAACA_CCGGAAAGAGTACGAC_TGCGTAGAATATTGCG_TCAGCTTCCCAAGAAA	P
TCTAGCGCGGCCGAAT_CTATGAGGTAGAAACA_TAAGTGCGTAAGTGAG_CAGATGGTCGGATATA_CTGGGCGCTGCTGCAT	P
TCTAGCGCGGCCGAAT_CTATGAGGTAGAAACA_CAGTGCTGCACACGAC_ATAATGAACGCTGGCT_CTAGCGTTCGTGCTGC	P
TCTAGCGCGGCCGAAT_CTATGAGGTAGAAACA_GCCTACGAATACAACC_GCATGATCACCCAGCC_TTTGCCCCGCACCCTC	P;R(A)
TCTAGCGCGGCCGAAT_CTATGAGGTAGAAACA_GCCTACGAATACAACC_GCATGATCACCCAGCC_AACGAAAAGGATTTCT	P
TCTAGCGCGGCCGAAT_CTATGAGGTAGAAACA_CCGGAAAGAGTACGAC_AATCGGGACTCCTATG_TTGACAAGTTCACGGT	P
TCTAGCGCGGCCGAAT_CTATGAGGTAGAAACA_GATAGATATAGTAAGT_CAATGCGACCACGAAG_GCATACGACCCAGGGG	P
TCTAGCGCGGCCGAAT_CTATGAGGTAGAAACA_CCGGAAAGAGTACGAC_CTAATGGGCTGATCTG_CTATTTAGATTTAAAC	P
TCTAGCGCGGCCGAAT_CTATGAGGTAGAAACA_CCGGAAAGAGTACGAC_CTAATGGGCTGATCTG_TCGAGTAAAGGAAACG	A
TCTAGCGCGGCCGAAT_CTATGAGGTAGAAACA_CCGGAAAGAGTACGAC_CTAATGGGCTGATCTG_TATGGGATGAATGAGG	P
TCTAGCGCGGCCGAAT_CTATGAGGTAGAAACA_CCGGAAAGAGTACGAC_CTAATGGGCTGATCTG_TGGCAGCAGGGCAAAA	P
TCTAGCGCGGCCGAAT_CTATGAGGTAGAAACA_CCGGAAAGAGTACGAC_CTAATGGGCTGATCTG_GCAATGCTTGTGTGCC	P
TCTAGCGCGGCCGAAT_CTATGAGGTAGAAACA_CCGGAAAGAGTACGAC_CTAATGGGCTGATCTG_CTGCAGATCTTTAGCA	P
TCTAGCGCGGCCGAAT_CTATGAGGTAGAAACA_CCGGAAAGAGTACGAC_CTAATGGGCTGATCTG_CTAAGGAAAAGACCAT	P
TCTAGCGCGGCCGAAT_CTATGAGGTAGAAACA_CCGGAAAGAGTACGAC_CTAATGGGCTGATCTG_ATAGTCTCCATACCAA	P
TCTAGCGCGGCCGAAT_CTATGAGGTAGAAACA_CCGGAAAGAGTACGAC_CTAATGGGCTGATCTG_AGCCAACACTAAAAAA	P
TCTAGCGCGGCCGAAT_CTATGAGGTAGAAACA_CCGGAAAGAGTACGAC_CTAATGGGCTGATCTG_AGGGTTCCGCAACGTC	A
TCTAGCGCGGCCGAAT_CTATGAGGTAGAAACA_CCGGAAAGAGTACGAC_CTAATGGGCTGATCTG_TTCCCCCGGGCGATTG	P
TCTAGCGCGGCCGAAT_CTATGAGGTAGAAACA_CCGGAAAGAGTACGAC_CTAATGGGCTGATCTG_CAGTTCGAGAGGCCCG	P
TCTAGCGCGGCCGAAT_CTATGAGGTAGAAACA_CCGGAAAGAGTACGAC_CTAATGGGCTGATCTG_CCGGGCCCCTTGGTCT	P
TCTAGCGCGGCCGAAT_CTATGAGGTAGAAACA_CCGGAAAGAGTACGAC_CTAATGGGCTGATCTG_TACTGGCCGGCGAGTT	P
TCTAGCGCGGCCGAAT_CTATGAGGTAGAAACA_CCGGAAAGAGTACGAC_CTAATGGGCTGATCTG_CTGCCAAAGGTGCTGG	P
TCTAGCGCGGCCGAAT_CTATGAGGTAGAAACA_CCGGAAAGAGTACGAC_CTAATGGGCTGATCTG_CCAGATATACGCTCCC	P
TCTAGCGCGGCCGAAT_CTATGAGGTAGAAACA_CCGGAAAGAGTACGAC_CTAATGGGCTGATCTG_AGTCATAGGGAATCGA	P
TCTAGCGCGGCCGAAT_CTATGAGGTAGAAACA_CCGGAAAGAGTACGAC_CTAATGGGCTGATCTG_CACAGGTCTAGCTCCG	P
TCTAGCGCGGCCGAAT_CTATGAGGTAGAAACA_CCGGAAAGAGTACGAC_CTAATGGGCTGATCTG_TCAGCTTCCCAAGAAA	P
TCTAGCGCGGCCGAAT_CTATGAGGTAGAAACA_CCGGAAAGAGTACGAC_CTAATGGGCTGATCTG_CGAGGCCCGGTTTTGA	P
TCTAGCGCGGCCGAAT_CTATGAGGTAGAAACA_CCGGAAAGAGTACGAC_CTAATGGGCTGATCTG_GACGCCTTACCCAGTG	P
TCTAGCGCGGCCGAAT_CTATGAGGTAGAAACA_CCGGAAAGAGTACGAC_CTAATGGGCTGATCTG_TAGTTAAATTGATGGC	A
TCTAGCGCGGCCGAAT_CTATGAGGTAGAAACA_CCGGAAAGAGTACGAC_CTAATGGGCTGATCTG_TTAATAGGGTAGGGGG	P
TCTAGCGCGGCCGAAT_CTATGAGGTAGAAACA_CCGGAAAGAGTACGAC_CTAATGGGCTGATCTG_GGACGCGTTTTGCAGT	P
TCTAGCGCGGCCGAAT_CTATGAGGTAGAAACA_CCGGAAAGAGTACGAC_CTAATGGGCTGATCTG_AATAATACTGTCCCGA	P
TCTAGCGCGGCCGAAT_CTATGAGGTAGAAACA_CCGGAAAGAGTACGAC_CTAATGGGCTGATCTG_GAAAAACCTCATTCGC	P
TCTAGCGCGGCCGAAT_CTATGAGGTAGAAACA_CCGGAAAGAGTACGAC_CTAATGGGCTGATCTG_AAACCATAGCGTCTAC	P
TCTAGCGCGGCCGAAT_CTATGAGGTAGAAACA_CCGGAAAGAGTACGAC_CTAATGGGCTGATCTG_CGATTTGGACCAGTCC	P
TCTAGCGCGGCCGAAT_CTATGAGGTAGAAACA_CCGGAAAGAGTACGAC_CTAATGGGCTGATCTG_AGGGGCCGACGGTACC	A
TCTAGCGCGGCCGAAT_CTATGAGGTAGAAACA_CCGGAAAGAGTACGAC_CTAATGGGCTGATCTG_ACATCTAACAACCATT	P
TCTAGCGCGGCCGAAT_CTATGAGGTAGAAACA_GCCTACGAATACAACC_TGAAGCTAGTTAGCGA_CGAGGACTAGAGTCAC	A;R(P)
TCTAGCGCGGCCGAAT_CTATGAGGTAGAAACA_GCCTACGAATACAACC_GAGTACAAGGCGAAGT_GCAGTCCGCTGGCCCT	A
TCTAGCGCGGCCGAAT_CTATGAGGTAGAAACA_GCCTACGAATACAACC_CGAACGCGGGTGGCAT_GGTAGTAATGGGTGTA	A
TCTAGCGCGGCCGAAT_CTATGAGGTAGAAACA_GCCTACGAATACAACC_CGAACGCGGGTGGCAT_AACAGAGATTTGTGCC	A
TCTAGCGCGGCCGAAT_CTATGAGGTAGAAACA_TAAGTGCGTAAGTGAG_GGTAGCTCACCTTTCG_AAAGTATGCCGAATTC	P
TCTAGCGCGGCCGAAT_CTATGAGGTAGAAACA_CAGTGCTGCACACGAC_ACACGGTGATACTGAG_AGGGTCCTCAGGTGCG	P
TCTAGCGCGGCCGAAT_CTATGAGGTAGAAACA_CAGTGCTGCACACGAC_ACACGGTGATACTGAG_TGTCTCCGCGTGTGGT	P;R(C)
TCTAGCGCGGCCGAAT_CTATGAGGTAGAAACA_TTAAGAGTAAGAGAGT_TAGTAAGAATCATCAT_TTCAGACACGGAGACC	P
TCTAGCGCGGCCGAAT_CTATGAGGTAGAAACA_GTACAGACTGCATGCT_GAGTTACCAAAGTAAT_TCGTCTCAGCGTCATG	P
TCTAGCGCGGCCGAAT_CTATGAGGTAGAAACA_GTACAGACTGCATGCT_GAGTTACCAAAGTAAT_GTTGGATGACATGTCG	P
TCTAGCGCGGCCGAAT_CTATGAGGTAGAAACA_GCCCATGGATAGATTG_CGGGCCCGCGGCCTCA_GTACCCCGGCGTGATT	P
TCTAGCGCGGCCGAAT_CTATGAGGTAGAAACA_TTAAGAGTAAGAGAGT_ACCATCAATGCTGCGA_TTGGTTTAATCGAGTC	A
TCTAGCGCGGCCGAAT_CTATGAGGTAGAAACA_GAAGGCGGTTTGGCAT_TTAATCGGAGCGATAC_ATGTATTGCTGGCACC	P
TCTAGCGCGGCCGAAT_CTATGAGGTAGAAACA_GAAGGCGGTTTGGCAT_TTAATCGGAGCGATAC_TATCTTCGCGAACCAT	P
TCTAGCGCGGCCGAAT_CTATGAGGTAGAAACA_GAAGGCGGTTTGGCAT_TTAATCGGAGCGATAC_ATTTCGTCGACAGAAC	P
TCTAGCGCGGCCGAAT_CTATGAGGTAGAAACA_GAAGGCGGTTTGGCAT_AGTAGGTTATGTAAAG_TTGACCCAGGAAATGA	P
TCTAGCGCGGCCGAAT_CTATGAGGTAGAAACA_GAAGGCGGTTTGGCAT_AGTAGGTTATGTAAAG_CTAATTGGAGCATGGA	P
CGCGGTGGAACGGAGG_CGCAACATGTAAACTT_AACGGCGGTGCTAGCC_CCTGCCTTATGGGCGC_GGGAGGAGTCACTTAT	P
TCTAGCGCGGCCGAAT_CTATGAGGTAGAAACA_GAAGGCGGTTTGGCAT_GAAGCCTATAGCTATT_TTAATTCTCGTACGTG	P
TCTAGCGCGGCCGAAT_CTATGAGGTAGAAACA_CAGTGCTGCACACGAC_CACTTGAAGAGCAGCC_TATTTGTTCGGCATAC	P
TCTAGCGCGGCCGAAT_CTATGAGGTAGAAACA_CAGTGCTGCACACGAC_CACTTGAAGAGCAGCC_CCATGGTATATCTGAC	P
TCTAGCGCGGCCGAAT_CTATGAGGTAGAAACA_CAGTGCTGCACACGAC_CACTTGAAGAGCAGCC_AGACAGCCGTGGGTAA	P
TCTAGCGCGGCCGAAT_CTATGAGGTAGAAACA_GATAGATATAGTAAGT_ATTCGGCTCATAAGGG_CGAGCCCTGATACTAT	P
TCTAGCGCGGCCGAAT_CTATGAGGTAGAAACA_GATAGATATAGTAAGT_ATTCGGCTCATAAGGG_ATTCTGGTGGCTAAAC	A
TCTAGCGCGGCCGAAT_CTATGAGGTAGAAACA_GATAGATATAGTAAGT_ATTCGGCTCATAAGGG_ACACAGCTCTCCTTCG	P
TCTAGCGCGGCCGAAT_CTATGAGGTAGAAACA_GATAGATATAGTAAGT_ATTCGGCTCATAAGGG_GCTCCTCCACAACCGG	P;R(A)
TCTAGCGCGGCCGAAT_CTATGAGGTAGAAACA_GATAGATATAGTAAGT_ATTCGGCTCATAAGGG_TCCGTAAGCCCGCACT	P
TCTAGCGCGGCCGAAT_CTATGAGGTAGAAACA_GATAGATATAGTAAGT_ATTCGGCTCATAAGGG_CAACCTTTGCGTTAAT	P
TCTAGCGCGGCCGAAT_CTATGAGGTAGAAACA_GTACAGACTGCATGCT_CTATAACAATTGCGGA_TCGTTGAGATAACAGC	P
TCTAGCGCGGCCGAAT_CTATGAGGTAGAAACA_GTACAGACTGCATGCT_CTATAACAATTGCGGA_TCATGCATGGACCGAA	P
TCTAGCGCGGCCGAAT_CTATGAGGTAGAAACA_GTACAGACTGCATGCT_CTATAACAATTGCGGA_TCTGGGTGACCCGCAG	P
TCTAGCGCGGCCGAAT_CTATGAGGTAGAAACA_GTACAGACTGCATGCT_CTATAACAATTGCGGA_ATAGGGATTCTAATCG	P
TCTAGCGCGGCCGAAT_CTATGAGGTAGAAACA_GTACAGACTGCATGCT_CTATAACAATTGCGGA_CTCGCCTGTCGTTTTT	C
TCTAGCGCGGCCGAAT_CTATGAGGTAGAAACA_GTACAGACTGCATGCT_CTATAACAATTGCGGA_TGGTCTACGCGCGGAC	P
TCTAGCGCGGCCGAAT_CTATGAGGTAGAAACA_GTACAGACTGCATGCT_CTATAACAATTGCGGA_CACCGTAGGAACCTCA	P
TCTAGCGCGGCCGAAT_CTATGAGGTAGAAACA_GTACAGACTGCATGCT_CTATAACAATTGCGGA_GATGTCGTCCAAACGG	P
TCTAGCGCGGCCGAAT_CTATGAGGTAGAAACA_GTACAGACTGCATGCT_CTATAACAATTGCGGA_TTTAATGTTGGTTCAT	P
TCTAGCGCGGCCGAAT_CTATGAGGTAGAAACA_GTACAGACTGCATGCT_CTATAACAATTGCGGA_TCGGGAAGCTACACCT	P
TCTAGCGCGGCCGAAT_CTATGAGGTAGAAACA_GTACAGACTGCATGCT_CTATAACAATTGCGGA_TTGAAAGCTGGAGATA	P
TCTAGCGCGGCCGAAT_CTATGAGGTAGAAACA_GTACAGACTGCATGCT_CTATAACAATTGCGGA_CCTAATCTCCTACGAG	P
TCTAGCGCGGCCGAAT_CTATGAGGTAGAAACA_GTACAGACTGCATGCT_CTATAACAATTGCGGA_GCCAGCAAGATAATTT	P
TCTAGCGCGGCCGAAT_CTATGAGGTAGAAACA_GTACAGACTGCATGCT_CTATAACAATTGCGGA_TAATTAGTTACGGCTA	P
TCTAGCGCGGCCGAAT_CTATGAGGTAGAAACA_GTACAGACTGCATGCT_CTATAACAATTGCGGA_CGCGCGAAATGAATAC	P
TCTAGCGCGGCCGAAT_CTATGAGGTAGAAACA_GTACAGACTGCATGCT_CTATAACAATTGCGGA_AGGTAAATCGGTCTCC	P
TCTAGCGCGGCCGAAT_CTATGAGGTAGAAACA_GTACAGACTGCATGCT_CTATAACAATTGCGGA_TAGTAACGGGTCAGGG	P
TCTAGCGCGGCCGAAT_CTATGAGGTAGAAACA_GTACAGACTGCATGCT_CTATAACAATTGCGGA_CTTACCTGCTGGGCGA	P
TCTAGCGCGGCCGAAT_CTATGAGGTAGAAACA_GTACAGACTGCATGCT_CTATAACAATTGCGGA_GCGATGAGCATGGCGC	P
TCTAGCGCGGCCGAAT_CTATGAGGTAGAAACA_GTACAGACTGCATGCT_CTATAACAATTGCGGA_ATATGGAGGCGGTGTA	P
TCTAGCGCGGCCGAAT_CTATGAGGTAGAAACA_GTACAGACTGCATGCT_CTATAACAATTGCGGA_CTGCGGCAGTAAGAGT	P
TCTAGCGCGGCCGAAT_CTATGAGGTAGAAACA_GTACAGACTGCATGCT_CTATAACAATTGCGGA_GTAGTATGGTGACGGA	P
