BC	flags
TCTAGCGCGGCCGAAT_CTATGAGGTAGAAACA_GATAGATATAGTAAGT_CAACGAAAAATGCGAT_GGCGAGCGACTTAGAC_TAGAGAGCTCGTGATA	B
CGCGGTGGAACGGAGG_CGCAACATGTAAACTT_ACGGTCGGTCAGGTTT_TCAGGCAACAGGGAGT_CCAAGTAGTGAGCCCG_AAGCCGAGAGCAGAAC	P
CGCGGTGGAACGGAGG_CGCAACATGTAAACTT_AACGATGATACGTGGT_AGTATTATGCGACGCC_ACATCCCCGTACTCCA_ATCCGTAGCATGACGA	P
CGCGGTGGAACGGAGG_CGCAACATGTAAACTT_AACGATGATACGTGGT_AGTATTATGCGACGCC_ACATCCCCGTACTCCA_GTTCCAGACATAGATT	P
CGCGGTGGAACGGAGG_CGCAACATGTAAACTT_AACGATGATACGTGGT_AGTATTATGCGACGCC_ACATCCCCGTACTCCA_AAGCCTCTACGTTTTG	P
CGCGGTGGAACGGAGG_CGCAACATGTAAACTT_AACGATGATACGTGGT_AGTATTATGCGACGCC_ACATCCCCGTACTCCA_AGTCGGACGGCGTAGC	P
CGCGGTGGAACGGAGG_CGCAACATGTAAACTT_AACGATGATACGTGGT_AGTATTATGCGACGCC_ACATCCCCGTACTCCA_AGACAATCCACTAAAT	P
CGCGGTGGAACGGAGG_CGCAACATGTAAACTT_AACGATGATACGTGGT_AGTATTATGCGACGCC_ACATCCCCGTACTCCA_ATATTGAACGTCCTGG	P
CGCGGTGGAACGGAGG_CGCAACATGTAAACTT_AACGATGATACGTGGT_AGTATTATGCGACGCC_ACATCCCCGTACTCCA_ACAGGATTGCCTAGTA	P
CGCGGTGGAACGGAGG_CGCAACATGTAAACTT_AACGATGATACGTGGT_AGTATTATGCGACGCC_AGTGGGCCATTTAGAG_GTCCAAATCGGGGGGG	P
GTTTAATTTAATCGTG_TCCACTGCTTTAAGTG_TAACGAACACGTACGC_TAGCCTGAGACTGTAT_CCGGTAGGTGGGACCT_GATCTCTTTGACGGAG	B
GTTTAATTTAATCGTG_TCCACTGCTTTAAGTG_TAACGAACACGTACGC_TAGCCTGAGACTGTAT_CCGGTAGGTGGGACCT_CAGGCCCGCGCGGTTT	P
TCTAGCGCGGCCGAAT_CTATGAGGTAGAAACA_TAAGTGCGTAAGTGAG_TCCAGAGCAAATGTAT_TTATCGGCCTCCCCAG_CGACCTTGATTGAGTT	P
CGCGGTGGAACGGAGG_CGCAACATGTAAACTT_AACGATGATACGTGGT_AGTATTATGCGACGCC_GCACAAAAAGGAATAG_AGTCCCGGAGACACGG	P;R(B)
CGCGGTGGAACGGAGG_CGCAACATGTAAACTT_AACGATGATACGTGGT_AGTATTATGCGACGCC_GCACAAAAAGGAATAG_AGCGAACATTGCTGGG	P
CGCGGTGGAACGGAGG_CGCAACATGTAAACTT_AACGATGATACGTGGT_AGTATTATGCGACGCC_CGGCGCGGAACTGACA_CAGACTTCGTATCATA	P
CGCGGTGGAACGGAGG_CGCAACATGTAAACTT_AACGATGATACGTGGT_AGTATTATGCGACGCC_CGGCGCGGAACTGACA_GGAAAGTGCTTGTCGA	P
TCCATTGAGAACAACT_ACCTAGGTCGTGGGAG_AACGTTAAGTGTTCAT_GTCATTCTAAGGCCGG_CTCACGTATATCGGTA_TAAACGCGCAGGCGAC	P;R(B)
CCACGCGCGGTACGTC_TGCCACACACGACGAT_TATGTAGATCCAATGG_CCGTCGAACGCGTAAT_GTCAATATCACCGAAA_ACGAGAGCACTGTCGA	P
TGCTAAAAAGATCTAG_TGTGTTCAGGGGGCTG_TAGAACCCGAGAGGGT_AGTCGGATGTACTCCC_CCATAGTAGTATGGCG_TCGGTCCTGACATCAT	P;R(B)
CGCGGTGGAACGGAGG_CGCAACATGTAAACTT_AACGATGATACGTGGT_AGTATTATGCGACGCC_CTACTCTAGGCGGACT_GGATACCAGCCCTCGC	P
CGCGGTGGAACGGAGG_CGCAACATGTAAACTT_TGTACCGCAATTATAC_GTTGTGTGCGCTCTCC_TGGCCGCTTGCGTGTT_GATAAGTTGGGCCCGT	P
TGCTAAAAAGATCTAG_TGTGTTCAGGGGGCTG_TTATCGGACAGCGTGC_CCAGCTGGTCCGCCAG_GAGCTGGCGTACTGAA_AAGGAAACGCGTTTAG	P
CGCGGTGGAACGGAGG_CGCAACATGTAAACTT_AACGATGATACGTGGT_AGTATTATGCGACGCC_GTCAGATCCAGTGTTG_CCATTCTAAGTGGCAA	P
TCCATTGAGAACAACT_TGCACACCCATGAGTA_GGTTGCAAGCATAGAA_GCTGTCGCGTTTCGTT_TTGCGAGGCCCGGAAT_GACTGCTGCACGTTGA	A
CGCGGTGGAACGGAGG_CGCAACATGTAAACTT_TGCCGCTCCACCGCTA_ATCGACTTCCTGTGCG_CTCAAATTGCACCGAT_TTAGGCTATGCAAAAA	B
CGCGGTGGAACGGAGG_CGCAACATGTAAACTT_TCTACGAACGAGTAGC_ATGAAGGTCTACGTTC_AAGCACCAGCGGGTTT_TCGGACTGGGAGCTTG	A
CGCGGTGGAACGGAGG_CGCAACATGTAAACTT_CCTCTATCCCTGGGTA_TGCTAAACCCACACGC_GAGGTACTCCCGATGT_ATGAACGATGGGGTAA	P
CGCGGTGGAACGGAGG_CGCAACATGTAAACTT_AACGATGATACGTGGT_AGTATTATGCGACGCC_TGCCAGTCATGGTGTC_TAACCGGACGAGTTCC	P
CGCGGTGGAACGGAGG_CGCAACATGTAAACTT_AACGATGATACGTGGT_AGTATTATGCGACGCC_TGCCAGTCATGGTGTC_ACGGACAGTTCGCGAG	P
CGCGGTGGAACGGAGG_CGCAACATGTAAACTT_AACGATGATACGTGGT_AGTATTATGCGACGCC_TGCCAGTCATGGTGTC_GTAGCATACGTTCACC	P
CGCGGTGGAACGGAGG_CGCAACATGTAAACTT_AACGATGATACGTGGT_AGTATTATGCGACGCC_TGCCAGTCATGGTGTC_GAATGAAAGGTGGAAC	P
CGCGGTGGAACGGAGG_CGCAACATGTAAACTT_AACGATGATACGTGGT_AGTATTATGCGACGCC_TGCCAGTCATGGTGTC_CCTTTGCGCCGTGGCA	P
CGCGGTGGAACGGAGG_CGCAACATGTAAACTT_AACGATGATACGTGGT_AGTATTATGCGACGCC_GTGTCTGGTGCCCCCG_GCGTTGAACCACAGTA	P
CGAAGCGATGCGTGTA_CGTGTAACCCTCGCAA_TCTGTGAGATGGAGTC_AAGACTACACACGCTC_CGAACCGACTTACTTA_GACGTCGCCGCGACTG	P
TCTAGCGCGGCCGAAT_CTATGAGGTAGAAACA_GATAGATATAGTAAGT_CCCGTGAAGGACATTT_TGAGACTGGCGCGGCA_CATCAACATGGTCATC	P
TCTAGCGCGGCCGAAT_CTATGAGGTAGAAACA_GATAGATATAGTAAGT_CCCGTGAAGGACATTT_TGAGACTGGCGCGGCA_GCGGCACATCGGTGGT	P
TGCTAAAAAGATCTAG_TGTGTTCAGGGGGCTG_TATCAGCCGGTTAAAT_GGGTTAACGCGCTGTG_TATACCCCTACAGCAT_TTCCACAGTGCGACCA	P;R(B)
TCCATTGAGAACAACT_ACCTAGGTCGTGGGAG_TTGTCCCTAGTTGTGT_CATGGTTAAGGACTGT_AACAGTGTATAGAATC_GCACCGGTCCGGGTTG	P
TCCATTGAGAACAACT_ACCTAGGTCGTGGGAG_AACGTTAAGTGTTCAT_GTCATTCTAAGGCCGG_AGGGCCTCTACGTATT_CGACCCGTTCATGCAG	P;R(B)
TCCATTGAGAACAACT_ACCTAGGTCGTGGGAG_AACGTTAAGTGTTCAT_GTCATTCTAAGGCCGG_CCACGAGGGAGCTTTC_ATGCGTCCACGCGCAT	P;R(B)
CGCGGTGGAACGGAGG_CGCAACATGTAAACTT_TCTACGAACGAGTAGC_CAGATGAATCGACCTT_CCTCAGATAGCGGCTG_TAACGATTGGGCGCCA	P;R(B)
CGCGGTGGAACGGAGG_CGCAACATGTAAACTT_AACGATGATACGTGGT_AGTATTATGCGACGCC_AAACGACCTCGGCATT_TAACCAGTTGCACATT	P
CGCGGTGGAACGGAGG_CGCAACATGTAAACTT_AACGATGATACGTGGT_AGTATTATGCGACGCC_TAATCCAGCATACGCG_GGCCCTAATTCGGACG	P
CGCGGTGGAACGGAGG_CGCAACATGTAAACTT_AACGATGATACGTGGT_AGTATTATGCGACGCC_TAATCCAGCATACGCG_GTTCGGCAAACCGTGC	P
CGCGGTGGAACGGAGG_CGCAACATGTAAACTT_AACGATGATACGTGGT_AGTATTATGCGACGCC_TAATCCAGCATACGCG_ACGTGAGCGACCCCAT	P
CGCGGTGGAACGGAGG_CGCAACATGTAAACTT_AACGATGATACGTGGT_AGTATTATGCGACGCC_TAATCCAGCATACGCG_CCTTGCTGGCACGCAA	P;R(B)
TCTAGCGCGGCCGAAT_CTATGAGGTAGAAACA_CCGGAAAGAGTACGAC_CCAACGAAGTGATTCT_GAGGGTTCTCTTAATT_ACTGTCCTATCCTAGG	B;R(P)
CCACGCGCGGTACGTC_TGCCACACACGACGAT_TATGTAGATCCAATGG_AGACACATGACATCCA_CTGCTTAGACCGGTCG_AAGACTTGCCACATTC	B
TCTAGCGCGGCCGAAT_CTATGAGGTAGAAACA_GTACAGACTGCATGCT_CTATAACAATTGCGGA_GATGTCGTCCAAACGG_ATTCGCGGCCTCTTGC	P
CGCGGTGGAACGGAGG_CGCAACATGTAAACTT_CCCACTAGGATTTCTC_ACGTATTGGCGCAGGC_CACAGCATTTTGGGAG_CTACGCACTGTCGTGG	A
TCTAGCGCGGCCGAAT_CTATGAGGTAGAAACA_CCGGAAAGAGTACGAC_TAGGGAGTGAACCGTT_CTCGTGAAAAGCGTCG_ATTCAGATGGGTCCAC	P
TCTAGCGCGGCCGAAT_CTATGAGGTAGAAACA_CCGGAAAGAGTACGAC_GGCGTCGGGTTAGTGT_GAGAATGCTTAAATAG_AGACCGCAAAGTATTA	P
TCTAGCGCGGCCGAAT_CTATGAGGTAGAAACA_CCGGAAAGAGTACGAC_TCCGGGCGACTTTGGC_ACAGTGGTACGTTCAA_TGACGCGTCTAGTGAC	P
TCTAGCGCGGCCGAAT_CTATGAGGTAGAAACA_CCGGAAAGAGTACGAC_CTAATGGGCTGATCTG_AATAATACTGTCCCGA_AGCTCCCATGAATCCA	P
TCTAGCGCGGCCGAAT_CTATGAGGTAGAAACA_CCGGAAAGAGTACGAC_CCTCCTGTTCATTACC_TTTATGCCAACGCCGT_GTCAGAGTCAACATTA	P
TCTAGCGCGGCCGAAT_CTATGAGGTAGAAACA_CCGGAAAGAGTACGAC_TCAAGGGGCGCAGCCG_ACAGATACACACGGAA_ACTCAACATTAGGGGA	P
TCTAGCGCGGCCGAAT_CTATGAGGTAGAAACA_GAAGGCGGTTTGGCAT_TGGGGATTACGGGCTT_GTCTACGGCATCGGTC_TTAGCTTCCCGCAGTA	P
TCTAGCGCGGCCGAAT_CTATGAGGTAGAAACA_CAGTGCTGCACACGAC_ACACGGTGATACTGAG_AGGGTCCTCAGGTGCG_ATGTGCACCTCACGCC	P
TCTAGCGCGGCCGAAT_CTATGAGGTAGAAACA_GAAGGCGGTTTGGCAT_AACGGAATAGAGTATG_TTGTGGGCAGAGTGCA_CAACGCGTATCTCCGT	P
TCTAGCGCGGCCGAAT_CTATGAGGTAGAAACA_GATAGATATAGTAAGT_ATTCGGCTCATAAGGG_GCTCCTCCACAACCGG_TGGGCTTTAGGTGCGC	P
TCTAGCGCGGCCGAAT_CTATGAGGTAGAAACA_GTACAGACTGCATGCT_CTATAACAATTGCGGA_CAAAAACCCTCTGTTA_TATATGCGACGGCCCG	P
TCTAGCGCGGCCGAAT_CTATGAGGTAGAAACA_CAGGCACTCACGTTAC_GTCAGAATTCGGAAAA_TCCGAGATCTCTAAGT_CTTGGCGGCCCGTTAA	P
TCTAGCGCGGCCGAAT_CTATGAGGTAGAAACA_CCGGAAAGAGTACGAC_CGTTAGTCCTTTTGAT_TGGAGGGCAGGACTCT_TGGATCGAAATTAGGG	P
TCTAGCGCGGCCGAAT_CTATGAGGTAGAAACA_CCGGAAAGAGTACGAC_GGACACGTTTCGGCCC_TTATCGCGCCGGGATT_TCGCGGTCCCGTGCGT	P
TCTAGCGCGGCCGAAT_CTATGAGGTAGAAACA_CCGGAAAGAGTACGAC_CTAATGGGCTGATCTG_CTGCCAAAGGTGCTGG_TACGAGTGACGAAAAT	P
TCTAGCGCGGCCGAAT_CTATGAGGTAGAAACA_CCGGAAAGAGTACGAC_CTAATGGGCTGATCTG_ACATCTAACAACCATT_ACACGCACAGATTTCG	P
TCTAGCGCGGCCGAAT_CTATGAGGTAGAAACA_CCGGAAAGAGTACGAC_CTAATGGGCTGATCTG_CAGTTCGAGAGGCCCG_TCCACCCCATATGATT	P
TCTAGCGCGGCCGAAT_CTATGAGGTAGAAACA_CCGGAAAGAGTACGAC_TGCGTAGAATATTGCG_GCCGGATGACTCGGAC_TACGGGTCGGAGATCG	P
TCTAGCGCGGCCGAAT_CTATGAGGTAGAAACA_CCGGAAAGAGTACGAC_TGCGTAGAATATTGCG_GCCGGATGACTCGGAC_TTGACGCGAGCGCCTA	P
TCTAGCGCGGCCGAAT_CTATGAGGTAGAAACA_CAGTGCTGCACACGAC_GCACTAAGAGGCATAT_ACTTGTAAGGCCCTAT_ATGGCAGCATTAGAAA	P
CGCGGTGGAACGGAGG_CGCAACATGTAAACTT_AACGATGATACGTGGT_AGTATTATGCGACGCC_ACATCCCCGTACTCCA_CCAGGATCACGAACAA	P
CGCGGTGGAACGGAGG_CGCAACATGTAAACTT_AACGATGATACGTGGT_AGTATTATGCGACGCC_ACATCCCCGTACTCCA_TTGTCCCGTTCTACTG	P
CGCGGTGGAACGGAGG_CGCAACATGTAAACTT_AACGATGATACGTGGT_AGTATTATGCGACGCC_ACATCCCCGTACTCCA_TCCCAGCTTAAGACCC	P
CGCGGTGGAACGGAGG_CGCAACATGTAAACTT_AACGATGATACGTGGT_AGTATTATGCGACGCC_ACATCCCCGTACTCCA_TACGCGTAAACACTCG	P
CGCGGTGGAACGGAGG_CGCAACATGTAAACTT_AACGATGATACGTGGT_AGTATTATGCGACGCC_ACATCCCCGTACTCCA_AAATAACGGAGGAATC	P
TCTAGCGCGGCCGAAT_CTATGAGGTAGAAACA_GAAGGCGGTTTGGCAT_AGCTGATATGCCATGT_TGCGGACTGGTTCTTT_TAAAGGTCCAAGGTTG	P
TCTAGCGCGGCCGAAT_CTATGAGGTAGAAACA_GCCTACGAATACAACC_ACTGTCGTTCGTCCTG_GAGTTAGATCCTAGAC_GAATGCTGCTTTCGAC	A;R(P)
TCTAGCGCGGCCGAAT_CTATGAGGTAGAAACA_GTACAGACTGCATGCT_CTATAACAATTGCGGA_TCATGCATGGACCGAA_TCGAGTTACAACCAAA	P
ACTTCGGGTGTCGTAG_GAACAGTCGAAGAGTA_TGGACATAATGATAGT_ACGGGCTTATCCGGAC_AGGTCCTATCGGCGCA_GCCTGCTTCAGGTTTA	P
TCTAGCGCGGCCGAAT_CTATGAGGTAGAAACA_GATAGATATAGTAAGT_CCCGTGAAGGACATTT_CCTGCCGAACCTACCT_GTATCCTGCCTGGTGC	C
TCTAGCGCGGCCGAAT_CTATGAGGTAGAAACA_GATAGATATAGTAAGT_ATTCGGCTCATAAGGG_ATTCTGGTGGCTAAAC_CATCTGCAACCCCACC	P
TCTAGCGCGGCCGAAT_CTATGAGGTAGAAACA_GATAGATATAGTAAGT_ATTCGGCTCATAAGGG_ATTCTGGTGGCTAAAC_TACACTTGGTGACGGC	P
TCTAGCGCGGCCGAAT_CTATGAGGTAGAAACA_GATAGATATAGTAAGT_ATTCGGCTCATAAGGG_ATTCTGGTGGCTAAAC_GCGACCCTAGCGGATT	P
TCTAGCGCGGCCGAAT_CTATGAGGTAGAAACA_GCCTACGAATACAACC_CGAACGCGGGTGGCAT_AACAGAGATTTGTGCC_CCACTGCCTTGTTAAC	P
TCTAGCGCGGCCGAAT_CTATGAGGTAGAAACA_CCGGAAAGAGTACGAC_ATGCCGAGAACGTAGT_CAAGAATCGATCGTAG_CCGAGCAGACTTGCGC	P
TCTAGCGCGGCCGAAT_CTATGAGGTAGAAACA_CCGGAAAGAGTACGAC_CTAATGGGCTGATCTG_CGAGGCCCGGTTTTGA_CGAGTCATCTAACAGG	P
TCTAGCGCGGCCGAAT_CTATGAGGTAGAAACA_TTAAGAGTAAGAGAGT_TAGTAAGAATCATCAT_TTCAGACACGGAGACC_AACTCCTCGGGTAGAG	P
ACTTCGGGTGTCGTAG_GAACAGTCGAAGAGTA_TGGACATAATGATAGT_ACGGGCTTATCCGGAC_GCCTATGGAGTTCAGA_TAGTCCGAACCAACGT	P
GTTTAATTTAATCGTG_TCCACTGCTTTAAGTG_TAACGAACACGTACGC_TAGCCTGAGACTGTAT_CCGGTAGGTGGGACCT_GCACCGTAAGAACTGA	P
GTTTAATTTAATCGTG_TCCACTGCTTTAAGTG_TAACGAACACGTACGC_TAGCCTGAGACTGTAT_CCGGTAGGTGGGACCT_CTACGCTTGACCGCGT	P
GTTTAATTTAATCGTG_TCCACTGCTTTAAGTG_TAACGAACACGTACGC_TAGCCTGAGACTGTAT_CCGGTAGGTGGGACCT_ACGTAAGAAGTTATCA	P
TCTAGCGCGGCCGAAT_CTATGAGGTAGAAACA_GCCTACGAATACAACC_TGAAGCTAGTTAGCGA_CGAGGACTAGAGTCAC_TAGAGGTAGTGGTACC	P
TCTAGCGCGGCCGAAT_CTATGAGGTAGAAACA_GCCTACGAATACAACC_TGAAGCTAGTTAGCGA_CGAGGACTAGAGTCAC_ATTTCATGACCGAAAC	P
TCTAGCGCGGCCGAAT_CTATGAGGTAGAAACA_GCCTACGAATACAACC_TGAAGCTAGTTAGCGA_CGAGGACTAGAGTCAC_TAAGAGAACCCCACAT	P
TCTAGCGCGGCCGAAT_CTATGAGGTAGAAACA_GCCTACGAATACAACC_GTAATCGTCGAATAAA_ATACTCACACTGCTAC_GGGACCGTGGCACATA	P
TCTAGCGCGGCCGAAT_CTATGAGGTAGAAACA_GCCTACGAATACAACC_GTAATCGTCGAATAAA_ATACTCACACTGCTAC_TTAACTGGGGACGACA	P
TCTAGCGCGGCCGAAT_CTATGAGGTAGAAACA_GCCTACGAATACAACC_GTAATCGTCGAATAAA_ATACTCACACTGCTAC_TACAGACCTAAATGAT	P
TCTAGCGCGGCCGAAT_CTATGAGGTAGAAACA_CCGGAAAGAGTACGAC_AGGTCCCCGACTTTAA_AGCTACAGTCTGTCGC_CGCGACGTTTATATGT	C;R(P)
TCTAGCGCGGCCGAAT_CTATGAGGTAGAAACA_CCGGAAAGAGTACGAC_ATGCCGAGAACGTAGT_TTCACTGTGGCGGGAT_CGCTGAAGCGCAATTA	P;R(A)
TGCTAAAAAGATCTAG_TGTGTTCAGGGGGCTG_TGAGGGGGCCGGTTTG_ATTGTCATGCGCTAAC_CAAATGCAACATATGC_ATGACTAATTGGGACG	P
TCTAGCGCGGCCGAAT_CTATGAGGTAGAAACA_GAAGGCGGTTTGGCAT_TTAATCGGAGCGATAC_TATCTTCGCGAACCAT_CTGTCTAGTAACTGAC	P
TCTAGCGCGGCCGAAT_CTATGAGGTAGAAACA_CAGTGCTGCACACGAC_CACTTGAAGAGCAGCC_GTAGTATAGTCAGTAT_AGGTTCGCTACGGAGC	P
CGCGGTGGAACGGAGG_CGCAACATGTAAACTT_AACGATGATACGTGGT_AGTATTATGCGACGCC_GCACAAAAAGGAATAG_TGGGTTGCAGATCGCC	P
TCTAGCGCGGCCGAAT_CTATGAGGTAGAAACA_TAAGTGCGTAAGTGAG_CTGGTGTGTGGTGCGG_CTCCTGATACTCGACG_GGCTAGTCCGCTTGTC	P
TCTAGCGCGGCCGAAT_CTATGAGGTAGAAACA_TTAAGAGTAAGAGAGT_ATCAGTGTAAAGCCCA_TCGACTCCCCAGTGCC_GAGGCGCTCAATTACT	P
TCTAGCGCGGCCGAAT_CTATGAGGTAGAAACA_CAGTGCTGCACACGAC_TGCTTTCCAAAGTGTT_TCTGGCCCGGGATTAT_CAGCCGGGTCGTTTTC	A
TCTAGCGCGGCCGAAT_CTATGAGGTAGAAACA_CGCTTAGTACCCGGAT_TAGACGCAAGCTGTCA_ACCGCAGTGGACGCAG_GCGTTGGGCAAACGAG	P
TCTAGCGCGGCCGAAT_CTATGAGGTAGAAACA_CCGGAAAGAGTACGAC_TAGGGAGTGAACCGTT_AATCATCCGTCGCAGT_ACTTCGAGTCGCCTAC	P
TCTAGCGCGGCCGAAT_CTATGAGGTAGAAACA_TAAGTGCGTAAGTGAG_CCATAACGCCGGGGCA_CAGTGTTAGGTGTCCC_ATTCAGTGCCCTGGGA	P
TCTAGCGCGGCCGAAT_CTATGAGGTAGAAACA_GCCTACGAATACAACC_CCGGCAACCAGCTGCC_AGAATAGGTCAGGGTT_AAACGCTGTGATCATT	P
TCTAGCGCGGCCGAAT_CTATGAGGTAGAAACA_GCCTACGAATACAACC_CCGGCAACCAGCTGCC_AGAATAGGTCAGGGTT_CTTGCGCCCAAAAAGT	P
TCTAGCGCGGCCGAAT_CTATGAGGTAGAAACA_CAGTGCTGCACACGAC_GAGACGTAGTGTAACT_ATGCGCAAAATGTGTA_TACAGGACAGTATAGG	P
CGCGGTGGAACGGAGG_CGCAACATGTAAACTT_AACGATGATACGTGGT_AGTATTATGCGACGCC_CGGCGCGGAACTGACA_TCGTCTTCAGAAAGCG	C
CGCGGTGGAACGGAGG_CGCAACATGTAAACTT_AACGATGATACGTGGT_AGTATTATGCGACGCC_CGGCGCGGAACTGACA_ATAAATCGATGATTAG	P
TCTAGCGCGGCCGAAT_CTATGAGGTAGAAACA_GATAGATATAGTAAGT_ATTCGGCTCATAAGGG_AATGACCACCGCGTTT_AGGGTGATTAAGAAAT	P
TCTAGCGCGGCCGAAT_CTATGAGGTAGAAACA_CCGGAAAGAGTACGAC_TCCGGGCGACTTTGGC_AGATCCTCCATCAATG_AGGATAGATGGATGGC	P
TCTAGCGCGGCCGAAT_CTATGAGGTAGAAACA_CCGGAAAGAGTACGAC_ATGCCGAGAACGTAGT_TATGGTTGCGTAGGTC_CTCCGACACACCTGCT	P
TCTAGCGCGGCCGAAT_CTATGAGGTAGAAACA_GAAGGCGGTTTGGCAT_TGCTGCATTGTGGGAG_TGCACACTACCACAGT_TACCGGCGCAACTACA	P
TCTAGCGCGGCCGAAT_CTATGAGGTAGAAACA_CGCTTAGTACCCGGAT_CAAGAAGACAATGTGA_TACCGGTGGATGATTC_AAAAGAGTCTAAGACT	P
ACTTCGGGTGTCGTAG_GAACAGTCGAAGAGTA_TGGACATAATGATAGT_ACGGGCTTATCCGGAC_TGGACCGACAACGCTA_TTATTCAGCCAAGAAG	P
TCTAGCGCGGCCGAAT_CTATGAGGTAGAAACA_CCGGAAAGAGTACGAC_ATGCCGAGAACGTAGT_CAACGATAGCGCGAGC_ACTGATCTTCACCTTC	P
TCTAGCGCGGCCGAAT_CTATGAGGTAGAAACA_TAAGTGCGTAAGTGAG_GCAATCAAGTCCAACG_TGCTTTACGCGCTCAG_TAGGTAGATGTTTGAT	P
TAAATCTTGTCAGTCA_TCTGGACCCGGTAGAG_AATAAGCAAAGTCAGT_AAGGACATACTGTCCC_GTCGTTCTCAGCTCCG_CACGATAGGTTGTACA	P
TCTAGCGCGGCCGAAT_CTATGAGGTAGAAACA_GTACAGACTGCATGCT_CTATAACAATTGCGGA_TTTAATGTTGGTTCAT_CAGTGCATCGGACCTC	P
TCTAGCGCGGCCGAAT_CTATGAGGTAGAAACA_CAGGCACTCACGTTAC_GTCAGAATTCGGAAAA_ACAGCCAACTATATTA_CAATGCGGGGGGACCA	P
TCTAGCGCGGCCGAAT_CTATGAGGTAGAAACA_CCGGAAAGAGTACGAC_CTAATGGGCTGATCTG_GACGCCTTACCCAGTG_GTATCGTGCGAGCTAA	P
TCTAGCGCGGCCGAAT_CTATGAGGTAGAAACA_CCGGAAAGAGTACGAC_CGAATCAAACGTCCTC_TCGGGAATTAGGAGTT_GTTGATGCGGTGACGG	P
TCTAGCGCGGCCGAAT_CTATGAGGTAGAAACA_GTACAGACTGCATGCT_CTATAACAATTGCGGA_TCTGGGTGACCCGCAG_AATGTCTTAAGCAAGG	P
TCTAGCGCGGCCGAAT_CTATGAGGTAGAAACA_GTACAGACTGCATGCT_CTATAACAATTGCGGA_CTCGCCTGTCGTTTTT_TTGTGAACGAACATTG	P
TCTAGCGCGGCCGAAT_CTATGAGGTAGAAACA_GTACAGACTGCATGCT_CTATAACAATTGCGGA_CTCGCCTGTCGTTTTT_CGCTTTGTGTCTAATA	P
TCTAGCGCGGCCGAAT_CTATGAGGTAGAAACA_GTACAGACTGCATGCT_CTATAACAATTGCGGA_CTCGCCTGTCGTTTTT_CTTTAACGCCCAAAGG	C
TCTAGCGCGGCCGAAT_CTATGAGGTAGAAACA_CCGGAAAGAGTACGAC_CGTTAGTCCTTTTGAT_TCATTTGAGCTGAGTT_AAGGGCCAGATGTATC	P
TCTAGCGCGGCCGAAT_CTATGAGGTAGAAACA_CCGGAAAGAGTACGAC_AGGTCCCCGACTTTAA_CCAGCTCCTGAATGCC_AGGAAGGTCGTAAGGA	P
TCTAGCGCGGCCGAAT_CTATGAGGTAGAAACA_GTACAGACTGCATGCT_GAGTTACCAAAGTAAT_TCGTCTCAGCGTCATG_CAGCAAAGGTTTCCAG	P
TGCTAAAAAGATCTAG_TGTGTTCAGGGGGCTG_TTATCGGACAGCGTGC_CCAGCTGGTCCGCCAG_CATTGGAATCCGGGTG_AAAGAGGATGAGAATT	P
TGCTAAAAAGATCTAG_TGTGTTCAGGGGGCTG_TTATCGGACAGCGTGC_CCAGCTGGTCCGCCAG_CATTGGAATCCGGGTG_CGGATTCTTCCTGCGC	P
TCTAGCGCGGCCGAAT_CTATGAGGTAGAAACA_GAAGGCGGTTTGGCAT_TGGGGATTACGGGCTT_CAACAGGAATCAGCCC_TCCTGCGTGAGCTCCA	P
TCTAGCGCGGCCGAAT_CTATGAGGTAGAAACA_CCGGAAAGAGTACGAC_TAGGGAGTGAACCGTT_GAATGGGAAACAGTCG_AATACGCGTTGAGTAG	P
TCTAGCGCGGCCGAAT_CTATGAGGTAGAAACA_CCGGAAAGAGTACGAC_ATGCCGAGAACGTAGT_GGGCGCGTTTGCACAT_ATGACCAACCCAGGTA	P
TCTAGCGCGGCCGAAT_CTATGAGGTAGAAACA_GCCTACGAATACAACC_GCATTATCGGCGTGAG_TTCTTGTACAAGACCA_TGTACGCAAAGGAACC	P
ACTTCGGGTGTCGTAG_GAACAGTCGAAGAGTA_TGGACATAATGATAGT_ACGGGCTTATCCGGAC_CGTGTGTCGACAGGGA_GCAGATCAGCACGCAT	P
TCTAGCGCGGCCGAAT_CTATGAGGTAGAAACA_GCCTACGAATACAACC_ATCGGTGTGCCCGCGC_TGTACGTGCCCGTGTA_TAAAGTAATTAGCGCG	P
TCTAGCGCGGCCGAAT_CTATGAGGTAGAAACA_GAAGGCGGTTTGGCAT_CATTGCGGCGATTCCC_TAGAACCCCAACATTT_CTCGACATGTGCACCG	P
TCTAGCGCGGCCGAAT_CTATGAGGTAGAAACA_CCGGAAAGAGTACGAC_CGTTAGTCCTTTTGAT_TGGCGACGTAATGTCG_TGTTGCTGGAGGGCTT	P
ACTTCGGGTGTCGTAG_GAACAGTCGAAGAGTA_TGGACATAATGATAGT_ACGGGCTTATCCGGAC_CTAGTTGGTTCCCGAG_TCAGTCAATGTGGGAT	P
TCTAGCGCGGCCGAAT_CTATGAGGTAGAAACA_TTAAGAGTAAGAGAGT_ATCAGTGTAAAGCCCA_ACTGTATGCAGCGATC_AAAAGCGCAGAGCTGA	P
TCTAGCGCGGCCGAAT_CTATGAGGTAGAAACA_TTAAGAGTAAGAGAGT_ATCAGTGTAAAGCCCA_ACTGTATGCAGCGATC_ATCGAGCAGAAAGGTC	P
TCTAGCGCGGCCGAAT_CTATGAGGTAGAAACA_GAAGGCGGTTTGGCAT_TGCTGCATTGTGGGAG_TCCAGTAGTGCGTCCG_CGAAGGTAAGCCAGGG	P
TCTAGCGCGGCCGAAT_CTATGAGGTAGAAACA_CCGGAAAGAGTACGAC_TCAAGGGGCGCAGCCG_ATCCATCGCACAGCGA_TGCAGCGTACTACTAG	P
TCTAGCGCGGCCGAAT_CTATGAGGTAGAAACA_GCCTACGAATACAACC_CGAACGCGGGTGGCAT_GGTAGTAATGGGTGTA_GACTGGTTCTTGACTG	P;R(A)
TCTAGCGCGGCCGAAT_CTATGAGGTAGAAACA_CCGGAAAGAGTACGAC_CTAATGGGCTGATCTG_CTGCAGATCTTTAGCA_CCCAACACACCACCAA	P
TCTAGCGCGGCCGAAT_CTATGAGGTAGAAACA_GAAGGCGGTTTGGCAT_CATTGCGGCGATTCCC_GAAGGTGATTGTGATT_GTACCGTCTCACATAT	P
ACTTCGGGTGTCGTAG_GAACAGTCGAAGAGTA_TGGACATAATGATAGT_ACGGGCTTATCCGGAC_AATACACGGCTCCCAA_TGCGATTAATGCGGCT	P
TCTAGCGCGGCCGAAT_CTATGAGGTAGAAACA_TAAGTGCGTAAGTGAG_CAGATGGTCGGATATA_CTGGGCGCTGCTGCAT_GCGGAGAGTTCTGCTC	P
TCTAGCGCGGCCGAAT_CTATGAGGTAGAAACA_GTACAGACTGCATGCT_CTATAACAATTGCGGA_GCCAGCAAGATAATTT_TGCTTGCTGGGTAGTT	P
TCTAGCGCGGCCGAAT_CTATGAGGTAGAAACA_GATAGATATAGTAAGT_ATTCGGCTCATAAGGG_ACACAGCTCTCCTTCG_AACACTCCCCACGTCC	P
TCTAGCGCGGCCGAAT_CTATGAGGTAGAAACA_CCGGAAAGAGTACGAC_CTAATGGGCTGATCTG_AAACCATAGCGTCTAC_CTCTGACCTGAAGAGA	P
TCTAGCGCGGCCGAAT_CTATGAGGTAGAAACA_TTAAGAGTAAGAGAGT_ACCATCAATGCTGCGA_TTGGTTTAATCGAGTC_TCTAGCGAGGCACTGT	P
TCTAGCGCGGCCGAAT_CTATGAGGTAGAAACA_TTAAGAGTAAGAGAGT_ACCATCAATGCTGCGA_TTGGTTTAATCGAGTC_CCCGTGTGCGTACGTA	P
CGCGGTGGAACGGAGG_CGCAACATGTAAACTT_AACGATGATACGTGGT_AGTATTATGCGACGCC_TGCCAGTCATGGTGTC_CGTGTATTTGTTCCCA	P
CGCGGTGGAACGGAGG_CGCAACATGTAAACTT_AACGATGATACGTGGT_AGTATTATGCGACGCC_TGCCAGTCATGGTGTC_ACCGTGAGGCAAGGTC	C
CGCGGTGGAACGGAGG_CGCAACATGTAAACTT_AACGATGATACGTGGT_AGTATTATGCGACGCC_TGCCAGTCATGGTGTC_CTCTTAACCGCTTGAT	C
TCTAGCGCGGCCGAAT_CTATGAGGTAGAAACA_CAGTGCTGCACACGAC_TACGTCCGGATCGACA_AGACAGCCGTGGGTAA_CTCCAGTCCGGTGATA	P
TCTAGCGCGGCCGAAT_CTATGAGGTAGAAACA_CCGGAAAGAGTACGAC_ATGCCGAGAACGTAGT_GTGAAGATAGTCAACG_ACATTTGCTGACTGCA	P
TCTAGCGCGGCCGAAT_CTATGAGGTAGAAACA_TAAGTGCGTAAGTGAG_TCAGGTCAAAAGCCAT_AGACGTCCGATCTATG_TAAGGAATCGCTCCTC	P
TCTAGCGCGGCCGAAT_CTATGAGGTAGAAACA_TAAGTGCGTAAGTGAG_TCAGGTCAAAAGCCAT_AGACGTCCGATCTATG_GACTGCGGGGCTTATC	P
TCTAGCGCGGCCGAAT_CTATGAGGTAGAAACA_TAAGTGCGTAAGTGAG_TCAGGTCAAAAGCCAT_AGACGTCCGATCTATG_TCAGGGCCAGGGACCA	P
TCTAGCGCGGCCGAAT_CTATGAGGTAGAAACA_TAAGTGCGTAAGTGAG_TCAGGTCAAAAGCCAT_AGACGTCCGATCTATG_GATACATCACAGCTGA	P
TCTAGCGCGGCCGAAT_CTATGAGGTAGAAACA_TAAGTGCGTAAGTGAG_TCAGGTCAAAAGCCAT_AGACGTCCGATCTATG_GACCCTAGACTTATGT	P
TCTAGCGCGGCCGAAT_CTATGAGGTAGAAACA_CCGGAAAGAGTACGAC_ATGCCGAGAACGTAGT_TGTGAATCCGGGTGCA_AAGTACCAAAAGGTGT	P
TCTAGCGCGGCCGAAT_CTATGAGGTAGAAACA_CCGGAAAGAGTACGAC_ATGCCGAGAACGTAGT_TGTGAATCCGGGTGCA_CACTATCGCCCCGATG	P
TCTAGCGCGGCCGAAT_CTATGAGGTAGAAACA_CCGGAAAGAGTACGAC_ATGCCGAGAACGTAGT_TGTGAATCCGGGTGCA_TCCTGCGTCCTAGTAG	P
TCTAGCGCGGCCGAAT_CTATGAGGTAGAAACA_GTACAGACTGCATGCT_CTATAACAATTGCGGA_CATTCCCATGTCGATA_CGAGAACCGCCTTCCT	P
TCTAGCGCGGCCGAAT_CTATGAGGTAGAAACA_CCGGAAAGAGTACGAC_AGGTCCCCGACTTTAA_GGTGCGGTGTTAAGCC_AACCGCGGAACCCGCG	P
CGCGGTGGAACGGAGG_CGCAACATGTAAACTT_AACGATGATACGTGGT_AGTATTATGCGACGCC_GTGTCTGGTGCCCCCG_GTTGCCGGAATATGAG	P
CGCGGTGGAACGGAGG_CGCAACATGTAAACTT_AACGATGATACGTGGT_AGTATTATGCGACGCC_GTGTCTGGTGCCCCCG_TGGTTTGCAGTGACTC	P
TCTAGCGCGGCCGAAT_CTATGAGGTAGAAACA_CCGGAAAGAGTACGAC_CCTCCTGTTCATTACC_ATCTTTCAGCGGCTGC_CGGCACTAACGGCGAA	P
TCTAGCGCGGCCGAAT_CTATGAGGTAGAAACA_CCGGAAAGAGTACGAC_CTAATGGGCTGATCTG_TTAATAGGGTAGGGGG_GGACTGCCGTATGGAC	P
TCTAGCGCGGCCGAAT_CTATGAGGTAGAAACA_TAAGTGCGTAAGTGAG_CTGGTGTGTGGTGCGG_CCTTGGACGCAGTGCA_TGGGATTCCCTGGCAT	P
TCTAGCGCGGCCGAAT_CTATGAGGTAGAAACA_CCGGAAAGAGTACGAC_GCTGACGCTGTCGATC_AGAGTGCAATTGCTGG_TGATCCGACAGGGCTC	P
TCTAGCGCGGCCGAAT_CTATGAGGTAGAAACA_TAAGTGCGTAAGTGAG_CTTCTGACGACCGCTG_GCGAAGAAAAATGCGG_ACCGTATTGCAAGCAA	P
TCTAGCGCGGCCGAAT_CTATGAGGTAGAAACA_CCGGAAAGAGTACGAC_CTAATGGGCTGATCTG_GGACGCGTTTTGCAGT_AATCCACGGAAGGTCA	P
TCTAGCGCGGCCGAAT_CTATGAGGTAGAAACA_GAAGGCGGTTTGGCAT_GTTGCCACTACGGGCA_AATAACCTAAACCATG_CCCACGCTCGACTCTC	P
TCTAGCGCGGCCGAAT_CTATGAGGTAGAAACA_GAAGGCGGTTTGGCAT_CTCGGCAATTCCCCGG_CGGCGTTGGGGGGACT_TCCTGTCGAGGTTGGA	P
TCTAGCGCGGCCGAAT_CTATGAGGTAGAAACA_CCGGAAAGAGTACGAC_CGTTAGTCCTTTTGAT_ACGACGGTACTGTTGC_CTTGGAGATGTTACGA	P
TCTAGCGCGGCCGAAT_CTATGAGGTAGAAACA_GATAGATATAGTAAGT_CCCGTGAAGGACATTT_TGAGACTGGCGCGGCA_TAAGAAGCCCTTCCAT	P
TCTAGCGCGGCCGAAT_CTATGAGGTAGAAACA_CCGGAAAGAGTACGAC_CTAATGGGCTGATCTG_AGGGTTCCGCAACGTC_ACCTATGATCGCATAA	P
TCTAGCGCGGCCGAAT_CTATGAGGTAGAAACA_CCGGAAAGAGTACGAC_CTAATGGGCTGATCTG_AGGGTTCCGCAACGTC_AGATGCGTTTTGTGTA	P
TCTAGCGCGGCCGAAT_CTATGAGGTAGAAACA_CCGGAAAGAGTACGAC_CTAATGGGCTGATCTG_AGGGTTCCGCAACGTC_GTTATCGGAGAAGGTT	P
TCTAGCGCGGCCGAAT_CTATGAGGTAGAAACA_CCGGAAAGAGTACGAC_CTAATGGGCTGATCTG_AGGGTTCCGCAACGTC_TCCTGGAAGGAAGGTA	P
TCTAGCGCGGCCGAAT_CTATGAGGTAGAAACA_CCGGAAAGAGTACGAC_TCAAGGGGCGCAGCCG_TAGCAATTCTGCCTGT_GCTAAACGGTCCATTA	P
TCTAGCGCGGCCGAAT_CTATGAGGTAGAAACA_GAAGGCGGTTTGGCAT_TGCTGCATTGTGGGAG_TGAGCTCAGAGCGCAA_CCCTGGTGACCATGGC	P
TCTAGCGCGGCCGAAT_CTATGAGGTAGAAACA_CCGGAAAGAGTACGAC_CTAATGGGCTGATCTG_TGGCAGCAGGGCAAAA_ATGATGCCATTCAGTT	P
TCTAGCGCGGCCGAAT_CTATGAGGTAGAAACA_CAGTGCTGCACACGAC_AACACATATTTGCTCA_CCCATCGATTCGCATA_AGATATTGATCGAGAG	P
TCTAGCGCGGCCGAAT_CTATGAGGTAGAAACA_GATAGATATAGTAAGT_GTACCGCGTGTGCCTT_TGCATGATGGCATCGC_GGCGGCCCTGTTGATC	P
GTTTAATTTAATCGTG_TCCACTGCTTTAAGTG_TAACGAACACGTACGC_TAGCCTGAGACTGTAT_AGAATACTGTAACCTC_GAACCGCTGTCTATCA	P
TCTAGCGCGGCCGAAT_CTATGAGGTAGAAACA_CCGGAAAGAGTACGAC_TAGGGAGTGAACCGTT_TCGATGTGACTATTCC_TCTCGTTACAGGGCTG	P
TCTAGCGCGGCCGAAT_CTATGAGGTAGAAACA_CCGGAAAGAGTACGAC_TAGGGAGTGAACCGTT_GCGCAATTTAGGGGAA_GAATCGAATGCAAGAA	P
TCTAGCGCGGCCGAAT_CTATGAGGTAGAAACA_CCGGAAAGAGTACGAC_TAGGGAGTGAACCGTT_GCGCAATTTAGGGGAA_CCCTACGAGTTTTTAT	P
TCTAGCGCGGCCGAAT_CTATGAGGTAGAAACA_CCGGAAAGAGTACGAC_TAGGGAGTGAACCGTT_TTGGTATATGCGGTGT_GGCCTCTTCTGAGTTC	P
TCTAGCGCGGCCGAAT_CTATGAGGTAGAAACA_GCCTACGAATACAACC_GAGTACAAGGCGAAGT_GCAGTCCGCTGGCCCT_AAGTTAGAATCTTCCG	P
TCTAGCGCGGCCGAAT_CTATGAGGTAGAAACA_GCCTACGAATACAACC_GAGTACAAGGCGAAGT_GCAGTCCGCTGGCCCT_GAGAACGGGTGATGAC	P
TCTAGCGCGGCCGAAT_CTATGAGGTAGAAACA_GCCTACGAATACAACC_GAGTACAAGGCGAAGT_GCAGTCCGCTGGCCCT_TAGTTGGATCTGCTCC	P
TCTAGCGCGGCCGAAT_CTATGAGGTAGAAACA_GCCTACGAATACAACC_GAGTACAAGGCGAAGT_GCAGTCCGCTGGCCCT_GACTCTGACGTGGGCA	P
TCTAGCGCGGCCGAAT_CTATGAGGTAGAAACA_GCCTACGAATACAACC_GAGTACAAGGCGAAGT_GCAGTCCGCTGGCCCT_TCCTCTGCCGGGTCAC	A
TCTAGCGCGGCCGAAT_CTATGAGGTAGAAACA_GCCTACGAATACAACC_GAGTACAAGGCGAAGT_GCAGTCCGCTGGCCCT_AGAACGAGGGACTCGG	P
TCTAGCGCGGCCGAAT_CTATGAGGTAGAAACA_GCCTACGAATACAACC_GAGTACAAGGCGAAGT_GCAGTCCGCTGGCCCT_GTTAACACCACAACCG	P
TCTAGCGCGGCCGAAT_CTATGAGGTAGAAACA_GCCTACGAATACAACC_GAGTACAAGGCGAAGT_GCAGTCCGCTGGCCCT_AGATCGGATCGCACCT	P
TCTAGCGCGGCCGAAT_CTATGAGGTAGAAACA_GCCTACGAATACAACC_GAGTACAAGGCGAAGT_GCAGTCCGCTGGCCCT_AGAAACGCGTTGAGAA	P
TCTAGCGCGGCCGAAT_CTATGAGGTAGAAACA_CAGTGCTGCACACGAC_CACTTGAAGAGCAGCC_TATTTGTTCGGCATAC_TTCGGGGAGCATTTAG	P
CGCGGTGGAACGGAGG_CGCAACATGTAAACTT_AACGGCGGTGCTAGCC_CCTGCCTTATGGGCGC_GGGAGGAGTCACTTAT_AATCCAGGTTACGCGG	P
TCTAGCGCGGCCGAAT_CTATGAGGTAGAAACA_CCGGAAAGAGTACGAC_CGCTGCTGGACTGTCT_CTACTGTCATCGCAAA_TACTGGTCGCCGACGA	P
TCTAGCGCGGCCGAAT_CTATGAGGTAGAAACA_CAGTGCTGCACACGAC_CACTTGAAGAGCAGCC_CCATGGTATATCTGAC_CAGGTTGCTTCTGCTC	P
TCTAGCGCGGCCGAAT_CTATGAGGTAGAAACA_CCGGAAAGAGTACGAC_TGCGTAGAATATTGCG_GCGCCACTCTGTGTTC_ACAATCCTGTAACCAT	P
TCTAGCGCGGCCGAAT_CTATGAGGTAGAAACA_CCGGAAAGAGTACGAC_TGCGTAGAATATTGCG_GCGCCACTCTGTGTTC_ACTAGTAACGAACTGT	P
TCTAGCGCGGCCGAAT_CTATGAGGTAGAAACA_CCGGAAAGAGTACGAC_TGCGTAGAATATTGCG_GCGCCACTCTGTGTTC_TAGGATTCCGCGAGTC	P
TCTAGCGCGGCCGAAT_CTATGAGGTAGAAACA_CCGGAAAGAGTACGAC_AATCGGGACTCCTATG_CATTGACACAGCTAAA_GGACCAGCTGAAATCT	P
TCTAGCGCGGCCGAAT_CTATGAGGTAGAAACA_CCGGAAAGAGTACGAC_AATCGGGACTCCTATG_CATTGACACAGCTAAA_CAAATTCCAAGGGTAA	P;R(C)
TCTAGCGCGGCCGAAT_CTATGAGGTAGAAACA_GTACAGACTGCATGCT_CTATAACAATTGCGGA_ATATGGAGGCGGTGTA_GTGAATTAAACAGTGA	P;R(A)
TCTAGCGCGGCCGAAT_CTATGAGGTAGAAACA_GTACAGACTGCATGCT_CTATAACAATTGCGGA_ATATGGAGGCGGTGTA_ACGCAATCATACTGTG	P;R(A)
TCTAGCGCGGCCGAAT_CTATGAGGTAGAAACA_CCGGAAAGAGTACGAC_AGGTCCCCGACTTTAA_ATGCGGATGTCATAAC_TGATACACGTAAAAGG	P
TCTAGCGCGGCCGAAT_CTATGAGGTAGAAACA_CGCTTAGTACCCGGAT_AACGGAGCAACTGCAG_AGCCATTACCTCTGCC_ACACCCCACTGAGTTT	P
TCTAGCGCGGCCGAAT_CTATGAGGTAGAAACA_CCGGAAAGAGTACGAC_TGCGTAGAATATTGCG_TCAGCTTCCCAAGAAA_GTTAGTAATAGAACCG	P
TCTAGCGCGGCCGAAT_CTATGAGGTAGAAACA_GAAGGCGGTTTGGCAT_AAAATGGGATAGGTCC_GCCCTAGTCCTTGAGC_TACCCGGGTCTGCCAT	P
TCTAGCGCGGCCGAAT_CTATGAGGTAGAAACA_GAAGGCGGTTTGGCAT_TGCTGCATTGTGGGAG_ACGGGTAGATCGACCA_GTGGGGAGGAAAATTC	A
TCTAGCGCGGCCGAAT_CTATGAGGTAGAAACA_GAAGGCGGTTTGGCAT_GAATGGAGATAGCATA_ATCTCTAGCCAATGTC_TTTACGGCCGCCGATG	P
TCTAGCGCGGCCGAAT_CTATGAGGTAGAAACA_CAGTGCTGCACACGAC_TTGCTGGCGCCGAGGT_ATTGGGCAAGGCGTAG_TCTACACCGGAACCCA	P
TCTAGCGCGGCCGAAT_CTATGAGGTAGAAACA_CCGGAAAGAGTACGAC_TCAAGGGGCGCAGCCG_GCCTGTTCAGCCTCTT_CCACAGTTCGGGAGAG	P
TCTAGCGCGGCCGAAT_CTATGAGGTAGAAACA_GTACAGACTGCATGCT_CTATAACAATTGCGGA_TGGTCTACGCGCGGAC_ATCCCATACAATGGCA	P
TCTAGCGCGGCCGAAT_CTATGAGGTAGAAACA_GTACAGACTGCATGCT_CTATAACAATTGCGGA_ATAGGGATTCTAATCG_TTAAAAATTGCGCCAA	P
TCTAGCGCGGCCGAAT_CTATGAGGTAGAAACA_CCGGAAAGAGTACGAC_GGGTTCGCAGGGTCTG_GTAGGTCACGCCAGTC_GCTGCACTCTTACTGC	P
TCTAGCGCGGCCGAAT_CTATGAGGTAGAAACA_CAATAATATGAGCCAA_GTCAGGTATCCCACAA_CATCTCGCACCCACGT_GGAGTCGTGGCGATTT	P
TCTAGCGCGGCCGAAT_CTATGAGGTAGAAACA_CCGGAAAGAGTACGAC_CGCTGCTGGACTGTCT_CGGGGTGTAAGCATAT_TGATACCATAAGCTGA	A
TCTAGCGCGGCCGAAT_CTATGAGGTAGAAACA_CCGGAAAGAGTACGAC_CGCTGCTGGACTGTCT_AATCAAGGAAGCGCGA_TACATAGCTAGCCGGT	P
TCTAGCGCGGCCGAAT_CTATGAGGTAGAAACA_CCGGAAAGAGTACGAC_GGCGTCGGGTTAGTGT_CTCTCCAATCACCGTG_ACCAGAGGCTGTAAAT	P
TCTAGCGCGGCCGAAT_CTATGAGGTAGAAACA_CCGGAAAGAGTACGAC_TAGGGAGTGAACCGTT_TATGACCAGAATCCGT_AAATAGTGGTTGAAAC	P
TCTAGCGCGGCCGAAT_CTATGAGGTAGAAACA_GCCTACGAATACAACC_GCATGATCACCCAGCC_ACAGCGACCGGTCCTC_GCGAAGAACATAACTT	P
TCTAGCGCGGCCGAAT_CTATGAGGTAGAAACA_GCCTACGAATACAACC_ATCGGTGTGCCCGCGC_ATTGGAGATTGTTGCC_GAATTACATCTGTCAG	P
TCTAGCGCGGCCGAAT_CTATGAGGTAGAAACA_GATAGATATAGTAAGT_CAATGCGACCACGAAG_GCATACGACCCAGGGG_GGTCGGCTCGTTCATA	P
TCTAGCGCGGCCGAAT_CTATGAGGTAGAAACA_CAGTGCTGCACACGAC_AACACATATTTGCTCA_GATAAGGAGTTGTCGT_AGATTGATACGGCTTG	P
TCTAGCGCGGCCGAAT_CTATGAGGTAGAAACA_CCGGAAAGAGTACGAC_TCCGGGCGACTTTGGC_TCAAGATACAAGTTCC_AAATTAAAGGCATTGT	P
TCTAGCGCGGCCGAAT_CTATGAGGTAGAAACA_CCGGAAAGAGTACGAC_CTAATGGGCTGATCTG_TAGTTAAATTGATGGC_ACCCACTATTATGCAA	P
TCTAGCGCGGCCGAAT_CTATGAGGTAGAAACA_CAGGCACTCACGTTAC_GTCAGAATTCGGAAAA_CAGTTGGCAACGCAAA_CTTCAGAGAGTTCGCT	P
TCTAGCGCGGCCGAAT_CTATGAGGTAGAAACA_CAGGCACTCACGTTAC_GTCAGAATTCGGAAAA_CAGTTGGCAACGCAAA_AACACCGGAGGTTCTG	P
TCTAGCGCGGCCGAAT_CTATGAGGTAGAAACA_CCGGAAAGAGTACGAC_AGGTCCCCGACTTTAA_AACCGAAATCGATAGT_TACCGCACCTACCAGG	P
TCTAGCGCGGCCGAAT_CTATGAGGTAGAAACA_GATAGATATAGTAAGT_ATTCGGCTCATAAGGG_GCTACACACTTGGTCG_TGGGAGGCGATTGAAG	P
TCTAGCGCGGCCGAAT_CTATGAGGTAGAAACA_CCGGAAAGAGTACGAC_CTAATGGGCTGATCTG_AGTCATAGGGAATCGA_GTCAATGGTATGAGGG	P
TCTAGCGCGGCCGAAT_CTATGAGGTAGAAACA_GCCTACGAATACAACC_GCATGATCACCCAGCC_TTTGCCCCGCACCCTC_AAAACGCCGTCGGCAT	P
TCTAGCGCGGCCGAAT_CTATGAGGTAGAAACA_GCCTACGAATACAACC_GCATGATCACCCAGCC_TTTGCCCCGCACCCTC_GCTAGAGGACTTGTAG	P
TCTAGCGCGGCCGAAT_CTATGAGGTAGAAACA_CCGGAAAGAGTACGAC_TAGGGAGTGAACCGTT_CGCAGTCACGAGGCTT_GTTCCTACGATTGCGA	P
TCTAGCGCGGCCGAAT_CTATGAGGTAGAAACA_CCGGAAAGAGTACGAC_CTAATGGGCTGATCTG_CACAGGTCTAGCTCCG_GACGATCCTATAGTTA	P
TCTAGCGCGGCCGAAT_CTATGAGGTAGAAACA_CAGTGCTGCACACGAC_AATCAAGAAAGTCCAA_AGTCGTCCTTCCGCTC_GTTCCGAATTGTACCG	P
TCTAGCGCGGCCGAAT_CTATGAGGTAGAAACA_GATAGATATAGTAAGT_TTGGCCCCGATTCGTC_TGCATGAATGTACGCT_CCAACGCTACAACGCT	P
TCTAGCGCGGCCGAAT_CTATGAGGTAGAAACA_CCGGAAAGAGTACGAC_CTAATGGGCTGATCTG_TATGGGATGAATGAGG_TGGTAAGCAGTACTCT	P
TCTAGCGCGGCCGAAT_CTATGAGGTAGAAACA_CCGGAAAGAGTACGAC_CTAATGGGCTGATCTG_AGGGGCCGACGGTACC_ACAGACACTAATGGCA	P
TCTAGCGCGGCCGAAT_CTATGAGGTAGAAACA_CCGGAAAGAGTACGAC_CTAATGGGCTGATCTG_AGGGGCCGACGGTACC_ACGCGCAGCTTTTGCA	P
TCTAGCGCGGCCGAAT_CTATGAGGTAGAAACA_CCGGAAAGAGTACGAC_CTAATGGGCTGATCTG_AGGGGCCGACGGTACC_AGATGAGACCGACTGA	P
TCTAGCGCGGCCGAAT_CTATGAGGTAGAAACA_CCGGAAAGAGTACGAC_CTAATGGGCTGATCTG_AGGGGCCGACGGTACC_CCAACGACAAGTACCG	P
TCTAGCGCGGCCGAAT_CTATGAGGTAGAAACA_CCGGAAAGAGTACGAC_CTAATGGGCTGATCTG_AGGGGCCGACGGTACC_TGCGGTCGGCATTCAT	P
TCTAGCGCGGCCGAAT_CTATGAGGTAGAAACA_CCGGAAAGAGTACGAC_CTAATGGGCTGATCTG_AGGGGCCGACGGTACC_AAGTTGACCTCTAGGA	P
TCTAGCGCGGCCGAAT_CTATGAGGTAGAAACA_CCGGAAAGAGTACGAC_CTAATGGGCTGATCTG_AGGGGCCGACGGTACC_GCATGAAGCCGGGAAC	C
TCTAGCGCGGCCGAAT_CTATGAGGTAGAAACA_CCGGAAAGAGTACGAC_CTAATGGGCTGATCTG_AGGGGCCGACGGTACC_ACTCTATGTGGGATGC	C
TCTAGCGCGGCCGAAT_CTATGAGGTAGAAACA_CCGGAAAGAGTACGAC_CTAATGGGCTGATCTG_AGGGGCCGACGGTACC_TGACACCGAGTAAGTT	P
TCTAGCGCGGCCGAAT_CTATGAGGTAGAAACA_CCGGAAAGAGTACGAC_CTAATGGGCTGATCTG_AGGGGCCGACGGTACC_TTTCACTCTAGTATGG	P
TCTAGCGCGGCCGAAT_CTATGAGGTAGAAACA_CCGGAAAGAGTACGAC_CTAATGGGCTGATCTG_AGGGGCCGACGGTACC_TTCATGAGAGGTCTCT	P
TCTAGCGCGGCCGAAT_CTATGAGGTAGAAACA_CCGGAAAGAGTACGAC_CTAATGGGCTGATCTG_AGGGGCCGACGGTACC_TGGGCGAGCACACATG	P
TCTAGCGCGGCCGAAT_CTATGAGGTAGAAACA_CCGGAAAGAGTACGAC_CTAATGGGCTGATCTG_AGGGGCCGACGGTACC_GATAAGCTCGGTAGAC	P
TCTAGCGCGGCCGAAT_CTATGAGGTAGAAACA_CCGGAAAGAGTACGAC_CTAATGGGCTGATCTG_AGGGGCCGACGGTACC_CGGCCCCGAGAAATTC	P
TCTAGCGCGGCCGAAT_CTATGAGGTAGAAACA_CCGGAAAGAGTACGAC_CTAATGGGCTGATCTG_AGGGGCCGACGGTACC_TCCAAACGACGGTACA	P
TCTAGCGCGGCCGAAT_CTATGAGGTAGAAACA_CCGGAAAGAGTACGAC_CTAATGGGCTGATCTG_AGGGGCCGACGGTACC_GACACAAGGTGATGCC	P
TCTAGCGCGGCCGAAT_CTATGAGGTAGAAACA_CCGGAAAGAGTACGAC_CTAATGGGCTGATCTG_AGGGGCCGACGGTACC_TGGTGTTCCGATGGGG	P
TCTAGCGCGGCCGAAT_CTATGAGGTAGAAACA_CCGGAAAGAGTACGAC_CTAATGGGCTGATCTG_AGGGGCCGACGGTACC_ATCCCTGCACAGATGA	P
TCTAGCGCGGCCGAAT_CTATGAGGTAGAAACA_CCGGAAAGAGTACGAC_CTAATGGGCTGATCTG_AGGGGCCGACGGTACC_ACCATAAATCACACCT	P
TCTAGCGCGGCCGAAT_CTATGAGGTAGAAACA_CCGGAAAGAGTACGAC_CTAATGGGCTGATCTG_AGGGGCCGACGGTACC_GGTAAACACGATTAAC	P
TCTAGCGCGGCCGAAT_CTATGAGGTAGAAACA_CCGGAAAGAGTACGAC_CTAATGGGCTGATCTG_AGGGGCCGACGGTACC_GTCATATGCTTTCTGG	P
TCTAGCGCGGCCGAAT_CTATGAGGTAGAAACA_CCGGAAAGAGTACGAC_CTAATGGGCTGATCTG_AGGGGCCGACGGTACC_GGGTTCTGTGCCCATC	P
TCTAGCGCGGCCGAAT_CTATGAGGTAGAAACA_CCGGAAAGAGTACGAC_CTAATGGGCTGATCTG_AGGGGCCGACGGTACC_TCCTCTGCCGGGTCAC	P
TCTAGCGCGGCCGAAT_CTATGAGGTAGAAACA_CCGGAAAGAGTACGAC_CTAATGGGCTGATCTG_AGGGGCCGACGGTACC_ATCCACAATCGATGGG	P
TCTAGCGCGGCCGAAT_CTATGAGGTAGAAACA_CCGGAAAGAGTACGAC_CTAATGGGCTGATCTG_AGGGGCCGACGGTACC_CGGTTGCCTTGTGGTC	P
TCTAGCGCGGCCGAAT_CTATGAGGTAGAAACA_CCGGAAAGAGTACGAC_TCAAGGGGCGCAGCCG_ATCACGGACTGCGAGT_CTTTACTAGTCCCTAA	P
TGCTAAAAAGATCTAG_TGTGTTCAGGGGGCTG_TAAGCTTAACGAGCCG_ATCCAACTTGAGGATA_AGGGCAGGCTCTCCCG_GCAGGATGAACAGGTG	P;R(A)
TGCTAAAAAGATCTAG_TGTGTTCAGGGGGCTG_TTATCGGACAGCGTGC_GCGGGACAGAATTATA_TGTGTTAGACAATTGC_AATAGGTAGGATATGG	P;R(A)
TCTAGCGCGGCCGAAT_CTATGAGGTAGAAACA_GTACAGACTGCATGCT_CTATAACAATTGCGGA_CGCGCGAAATGAATAC_TCTCTACAGTTCGGAA	P
CGCGGTGGAACGGAGG_CGCAACATGTAAACTT_AACGATGATACGTGGT_AGTATTATGCGACGCC_AAACGACCTCGGCATT_ATGCCCCCGGTTTGAC	P
CGCGGTGGAACGGAGG_CGCAACATGTAAACTT_AACGATGATACGTGGT_AGTATTATGCGACGCC_AAACGACCTCGGCATT_CTGCATAGGTGTAGGT	C
TCTAGCGCGGCCGAAT_CTATGAGGTAGAAACA_CAGTGCTGCACACGAC_ACCCGCGGGCCATTTC_ACTGTGAGTACCCGTC_CTTCACGCTAGGAGAA	P
TCTAGCGCGGCCGAAT_CTATGAGGTAGAAACA_CAGGCACTCACGTTAC_GTCAGAATTCGGAAAA_GTTCTCACCTGCTGAC_GAAAGCTATCGACAGT	P
TCTAGCGCGGCCGAAT_CTATGAGGTAGAAACA_CCGGAAAGAGTACGAC_TAGGGAGTGAACCGTT_TGCCTAGGGTAATGAT_GTCTGAAAGGCTCCGT	P
TCTAGCGCGGCCGAAT_CTATGAGGTAGAAACA_CCGGAAAGAGTACGAC_CTAATGGGCTGATCTG_TCGAGTAAAGGAAACG_CTGACATGTCGCTCTC	P
TCTAGCGCGGCCGAAT_CTATGAGGTAGAAACA_CCGGAAAGAGTACGAC_CTAATGGGCTGATCTG_TCGAGTAAAGGAAACG_GGATCACCAAAACGTC	P
TCTAGCGCGGCCGAAT_CTATGAGGTAGAAACA_CCGGAAAGAGTACGAC_CTAATGGGCTGATCTG_TCGAGTAAAGGAAACG_TCCTTCCACTCGGGCT	P
TCTAGCGCGGCCGAAT_CTATGAGGTAGAAACA_CCGGAAAGAGTACGAC_CTAATGGGCTGATCTG_TCGAGTAAAGGAAACG_CCGCAGTGGGTACATT	P
TCTAGCGCGGCCGAAT_CTATGAGGTAGAAACA_CCGGAAAGAGTACGAC_CTAATGGGCTGATCTG_TCGAGTAAAGGAAACG_CCTACGGTTTCCGGTT	P
TCTAGCGCGGCCGAAT_CTATGAGGTAGAAACA_CCGGAAAGAGTACGAC_CTAATGGGCTGATCTG_TCGAGTAAAGGAAACG_TACAGGTATGTTGCAA	P
TCTAGCGCGGCCGAAT_CTATGAGGTAGAAACA_CCGGAAAGAGTACGAC_CTAATGGGCTGATCTG_TCGAGTAAAGGAAACG_TGTCCCTTCTTCGCCA	P
TCTAGCGCGGCCGAAT_CTATGAGGTAGAAACA_CCGGAAAGAGTACGAC_CTAATGGGCTGATCTG_TCGAGTAAAGGAAACG_GCTTTCGGGGACGATA	P
TCTAGCGCGGCCGAAT_CTATGAGGTAGAAACA_CCGGAAAGAGTACGAC_CTAATGGGCTGATCTG_TCGAGTAAAGGAAACG_CCACTCGAACCCTAGG	P
TCTAGCGCGGCCGAAT_CTATGAGGTAGAAACA_CCGGAAAGAGTACGAC_CTAATGGGCTGATCTG_TCGAGTAAAGGAAACG_GGGCACTCATACGCTT	P
TCTAGCGCGGCCGAAT_CTATGAGGTAGAAACA_CCGGAAAGAGTACGAC_CTAATGGGCTGATCTG_TCGAGTAAAGGAAACG_TTAAAGAGTGAAATAA	P
TCTAGCGCGGCCGAAT_CTATGAGGTAGAAACA_CCGGAAAGAGTACGAC_CTAATGGGCTGATCTG_TCGAGTAAAGGAAACG_TTGTGAAATCCATTGC	P
TCTAGCGCGGCCGAAT_CTATGAGGTAGAAACA_CCGGAAAGAGTACGAC_CTAATGGGCTGATCTG_TCGAGTAAAGGAAACG_TTGGGCTTGTCAGCGA	P
TCTAGCGCGGCCGAAT_CTATGAGGTAGAAACA_CCGGAAAGAGTACGAC_ATGCCGAGAACGTAGT_GAAGGCCCGAATCACA_CTCAGCGCGCGTACTA	P
TCTAGCGCGGCCGAAT_CTATGAGGTAGAAACA_GTACAGACTGCATGCT_CTATAACAATTGCGGA_CTTACCTGCTGGGCGA_AACATCTTAGCTACAG	P
TCTAGCGCGGCCGAAT_CTATGAGGTAGAAACA_CAGTGCTGCACACGAC_ACACGGTGATACTGAG_TGTCTCCGCGTGTGGT_CCCCCTGCCCAGGTCT	P;R(C)
TCTAGCGCGGCCGAAT_CTATGAGGTAGAAACA_CGCTTAGTACCCGGAT_AGTCGTTGCGCAAGCG_ACCTCTGTCCACCTCG_CCAAGGAACAACAGGG	P
TCTAGCGCGGCCGAAT_CTATGAGGTAGAAACA_CCGGAAAGAGTACGAC_TCAAGGGGCGCAGCCG_TCCATCTAGGGTGCGA_CAGATACTACCATTCC	P
