BC	flags
GCAACCCTGCAACTTC_CAAGGAGGGTACTTCG_ACAGCGATGTCCATCC	A
TGCTAAAAAGATCTAG_TGTGTTCAGGGGGCTG_TAAGCTTAACGAGCCG	P
TGCTAAAAAGATCTAG_TGTGTTCAGGGGGCTG_TTATCGGACAGCGTGC	C
TGCTAAAAAGATCTAG_TGTGTTCAGGGGGCTG_TGAGGGGGCCGGTTTG	C
TGCTAAAAAGATCTAG_TGTGTTCAGGGGGCTG_TATCAGCCGGTTAAAT	P
TGCTAAAAAGATCTAG_TGTGTTCAGGGGGCTG_TGGCGGCATTTCGCGG	P
TGCTAAAAAGATCTAG_TGTGTTCAGGGGGCTG_TAGAACCCGAGAGGGT	P
TCTAGCGCGGCCGAAT_CTATGAGGTAGAAACA_AACCATGTCGCCGATA	P
CCACGCGCGGTACGTC_TGCCACACACGACGAT_TTCACTACCAATCTCC	A
CCACGCGCGGTACGTC_TGCCACACACGACGAT_TATGTAGATCCAATGG	A
TCCATTGAGAACAACT_ACCTAGGTCGTGGGAG_TTGTCCCTAGTTGTGT	A
TCCATTGAGAACAACT_ACCTAGGTCGTGGGAG_AACGTTAAGTGTTCAT	C
GTTTAATTTAATCGTG_TCCACTGCTTTAAGTG_TAACGAACACGTACGC	A
CGAAGCGATGCGTGTA_CGTGTAACCCTCGCAA_GGCTCTACACTCGGTC	P
CGAAGCGATGCGTGTA_CGTGTAACCCTCGCAA_TCTGTGAGATGGAGTC	A;R(P)
CGCGGTGGAACGGAGG_CGCAACATGTAAACTT_GCTTAGATGTTGGAGT	P;R(C)
CGCGGTGGAACGGAGG_CGCAACATGTAAACTT_AGAATTACCTCTGCAA	P
CGCGGTGGAACGGAGG_CGCAACATGTAAACTT_ACTGAGTAGGACTCAT	P
CGCGGTGGAACGGAGG_CGCAACATGTAAACTT_AAACTTAGGACGTTAT	P
CGCGGTGGAACGGAGG_CGCAACATGTAAACTT_TCATTAGAGTAGGTGT	P
CGCGGTGGAACGGAGG_CGCAACATGTAAACTT_TATACAACAATGCTCG	P
CGCGGTGGAACGGAGG_CGCAACATGTAAACTT_AAGCCCTAATTTCCTT	P
CGCGGTGGAACGGAGG_CGCAACATGTAAACTT_ACGGTCGGTCAGGTTT	C;R(P)
CGCGGTGGAACGGAGG_CGCAACATGTAAACTT_CCCACTAGGATTTCTC	P
CGCGGTGGAACGGAGG_CGCAACATGTAAACTT_TGTACCGCAATTATAC	C
CGCGGTGGAACGGAGG_CGCAACATGTAAACTT_AAAAAACTCGCGGGGT	P
CGCGGTGGAACGGAGG_CGCAACATGTAAACTT_GGCCCATAGGTCATCT	C
CGCGGTGGAACGGAGG_CGCAACATGTAAACTT_TGCCGCTCCACCGCTA	C
CGCGGTGGAACGGAGG_CGCAACATGTAAACTT_GCCGCTAGCTTGTGGC	P
CGCGGTGGAACGGAGG_CGCAACATGTAAACTT_CCTCTATCCCTGGGTA	P
CGCGGTGGAACGGAGG_CGCAACATGTAAACTT_GATACAGTTTTTCGAA	P
CGCGGTGGAACGGAGG_CGCAACATGTAAACTT_TCACGACTACGTACGT	P
CGCGGTGGAACGGAGG_CGCAACATGTAAACTT_CTATTACGTCACGCGC	P
CGCGGTGGAACGGAGG_CGCAACATGTAAACTT_ATGGGATTCAGTTGCC	P
CGCGGTGGAACGGAGG_CGCAACATGTAAACTT_AACGATGATACGTGGT	C
CGCGGTGGAACGGAGG_CGCAACATGTAAACTT_AAGAATTTCACCAATA	P
CGCGGTGGAACGGAGG_CGCAACATGTAAACTT_CTTGGGTAAAAAAGCC	P
CGCGGTGGAACGGAGG_CGCAACATGTAAACTT_TCTACGAACGAGTAGC	C
CGCGGTGGAACGGAGG_CGCAACATGTAAACTT_TAATTTGGGTACACGT	P
AGTAAGACCTCGGGCC_CGCGCTTGGTTGGCTC_TGGCGCCGAAAAAGTT	P;R(B)
ACTTCGGGTGTCGTAG_GAACAGTCGAAGAGTA_TGGACATAATGATAGT	C
TCCATTGAGAACAACT_TGCACACCCATGAGTA_CACGACATGGTAATGT	A;R(P)
TCCATTGAGAACAACT_TGCACACCCATGAGTA_GGTTGCAAGCATAGAA	C
GTGCGGACCCCGTGAT_ATCCAAAATCTGTGAC_TAGATTCATAGCTGGC	B;R(P)
ACAATCCGAATGAAGG_CTTGGAACTGCGTTGA_GTAGATCTTTGTAGAT	P
CCCGCAGAAAAGTAGC_CGCACCGAATTCCATC_GGCGAAAACTTGTTGT	B
CCTTGACCTCCGACTA_AAATCTTCCTACGCAA_TCCTGCGAGTGACAGG	P;+
CGTATGAAACCTGGGG_GGCAGGTTTTGCGCGA_ATATTCCTAGAAATTC	A
CTAGAGACACGTCTAC_ATGGTATATCAATGGC_CCACTTAGTCATGACT	C
TAAGGTTCAAAACTCC_TAGACCTTGCCAACAT_CCTCGTGCTCCGATGG	A
GTTAACGGCCAGTCAC_CCGTGTACACGGCCAT_AGATACGCTACCACAC	P
GAAAAGAGTGACGTTT_CATTGGCTCACACAAG_TGGTGGACACGATGAC	P
AAGTAAGCCACTCACC_CCCAGGTTAAGGCAAA_TGAACCTACACGGCAA	P
GCAACCCTGCAACTTC_CATACGGCAGTCAGTA_TTCTTAATACTTGCGG	P
GCAACCCTGCAACTTC_CATACGGCAGTCAGTA_TCCGGCAAGGTCACCT	P
GCAACCCTGCAACTTC_CAAGGAGGGTACTTCG_GCGCAGGTGGATGTCT	P
GCAACCCTGCAACTTC_CAAGGAGGGTACTTCG_CCGCGGGCTACTACAT	P
GCAACCCTGCAACTTC_CAAGGAGGGTACTTCG_TTCAGCACACTAACGT	P
GCAACCCTGCAACTTC_CAAGGAGGGTACTTCG_TAGCGCTCTCTAGACC	P
GCAACCCTGCAACTTC_CAAGGAGGGTACTTCG_CCCTACGCATTATGGT	P
GCAACCCTGCAACTTC_CAAGGAGGGTACTTCG_TGATCCGCTCTCCCGT	P
GCAACCCTGCAACTTC_CAAGGAGGGTACTTCG_TAAGGCGCGTAGGCCT	P
GCAACCCTGCAACTTC_CAAGGAGGGTACTTCG_ATACCCTGAAAAGCCC	P
TAAATCTTGTCAGTCA_TCTGGACCCGGTAGAG_AATAAGCAAAGTCAGT	C
TTGTCATCAGCGGTAA_CACGACTGGCACTTTT_GACAGCAGTATTGATT	P
TGCTAAAAAGATCTAG_TGTGTTCAGGGGGCTG_CGACGATTTTGTACAT	P
TCTAGCGCGGCCGAAT_CTATGAGGTAGAAACA_CAGTGCTGCACACGAC	P
TCTAGCGCGGCCGAAT_CTATGAGGTAGAAACA_CAGGCACTCACGTTAC	C
TCTAGCGCGGCCGAAT_CTATGAGGTAGAAACA_CAATAATATGAGCCAA	P
TCTAGCGCGGCCGAAT_CTATGAGGTAGAAACA_TTAAGAGTAAGAGAGT	C
TCTAGCGCGGCCGAAT_CTATGAGGTAGAAACA_CGCTTAGTACCCGGCT	P
TCTAGCGCGGCCGAAT_CTATGAGGTAGAAACA_CGCTTAGTACCCGGAT	P
TCTAGCGCGGCCGAAT_CTATGAGGTAGAAACA_GTACAGACTGCATGCT	C
TCTAGCGCGGCCGAAT_CTATGAGGTAGAAACA_TCATCGCAGAAGCCTC	P
TCTAGCGCGGCCGAAT_CTATGAGGTAGAAACA_TAAGTGCGTAAGTGAG	C
TCTAGCGCGGCCGAAT_CTATGAGGTAGAAACA_GCACGCTCGTGGACCT	P
TCTAGCGCGGCCGAAT_CTATGAGGTAGAAACA_CAGTGCTGCACACGCC	P
TCTAGCGCGGCCGAAT_CTATGAGGTAGAAACA_GCCTACGAATACAACC	C
TCTAGCGCGGCCGAAT_CTATGAGGTAGAAACA_GCCCATGGATAGATTG	P
TCTAGCGCGGCCGAAT_CTATGAGGTAGAAACA_GATGTGAGCATTCTAC	P
TCTAGCGCGGCCGAAT_CTATGAGGTAGAAACA_CCGGAAAGAGTACGCC	P
TCTAGCGCGGCCGAAT_CTATGAGGTAGAAACA_GAAGGCGGTTTGGCAT	C
TCTAGCGCGGCCGAAT_CTATGAGGTAGAAACA_CCGGAAAGAGTACGAC	A;R(C)
TCTAGCGCGGCCGAAT_CTATGAGGTAGAAACA_GATAGATATAGTAAGT	C
TGCGGCATAGTCCTCG_GTAGGTTATGCGGAAG_TCAGAGGGGTGCCAAC	P
TGCGGCATAGTCCTCG_GTAGGTTATGCGGAAG_GTTAAATACGAAACCA	P
TGCGGCATAGTCCTCG_GTAGGTTATGCGGAAG_GCATGATGCTCGTCGT	P
TGCGGCATAGTCCTCG_GTAGGTTATGCGGAAG_AAAGCAAACAATAATC	P
TGCGGCATAGTCCTCG_GTAGGTTATGCGGAAG_GACCAAATGGGGATAT	P
TGCGGCATAGTCCTCG_GTAGGTTATGCGGAAG_GTCTAAGGTGTTACCG	P
TGCGGCATAGTCCTCG_GTAGGTTATGCGGAAG_GTAAAGGTGGCCTGAC	P
TGCGGCATAGTCCTCG_GTAGGTTATGCGGAAG_TAGCAAATGCGGATTC	P
CCACGCGCGGTACGTC_TGCCACACACGACGAT_CAGATAACGATGGCCC	P
CCACGCGCGGTACGTC_TGCCACACACGACGAT_CTACAAGCATCCGATC	P
CCACGCGCGGTACGTC_TGCCACACACGACGAT_GACGTAGTTGCCGGAT	P
CCACGCGCGGTACGTC_TGCCACACACGACGAT_TTAAGATCTGCCTGTT	P
CCACGCGCGGTACGTC_TGCCACACACGACGAT_ATACGCAACTCGGTTT	C
CCACGCGCGGTACGTC_TGCCACACACGACGAT_AGAGAGAGTCAAGGGT	P
CCACGCGCGGTACGTC_TGCCACACACGACGAT_CTGGGGTTTGTGTGAT	P
CCACGCGCGGTACGTC_TGCCACACACGACGAT_TCAGTTTGCACCTAGG	P
TAAGGTTCAAAACTCC_TATGGGGCGCCTAATT_TCCCGAGGAGCCCATT	P
TCCATTGAGAACAACT_ACCTAGGTCGTGGGAG_TACCCCACGGTCGTAC	P
TCCATTGAGAACAACT_ACCTAGGTCGTGGGAG_CCCGAATATTAATTGG	P
TCCATTGAGAACAACT_ACCTAGGTCGTGGGAG_AGAGGAAAGTATTAAT	P
TCCATTGAGAACAACT_ACCTAGGTCGTGGGAG_AAACCCTGGGGTGCGC	P
TCCATTGAGAACAACT_ACCTAGGTCGTGGGAG_ATGTCCGCCGCGTTTT	P
TCCATTGAGAACAACT_ACCTAGGTCGTGGGAG_CATGACATTGAAGACA	P
TCCATTGAGAACAACT_ACCTAGGTCGTGGGAG_AAGGTCTACCATCCAG	P
TCCATTGAGAACAACT_ACCTAGGTCGTGGGAG_CTAACTAGGTAAGCGG	P
TCCATTGAGAACAACT_ACCTAGGTCGTGGGAG_TCCACGTAGTTTCGTC	P
CAATGGTCTGATCTAT_CAGTATTGTGACGCAT_AAACCCCCGGCCGATT	P
CAATGGTCTGATCTAT_CAGTATTGTGACGCAT_CGAGTTGAGCGAGTTA	P
CGAAGCGATGCGTGTA_CGTGTAACCCTCGCAA_GCTAGGGTACAGTAAG	P
CGAAGCGATGCGTGTA_CGTGTAACCCTCGCAA_AACTAATCCGCGTATG	P
CGAAGCGATGCGTGTA_CGTGTAACCCTCGCAA_GTTGAATTCAACGGGC	P
CGAAGCGATGCGTGTA_CGTGTAACCCTCGCAA_CCCAGCGACGCCTTTA	P
CGAAGCGATGCGTGTA_CGTGTAACCCTCGCAA_AAGACGTAGGCGATGC	P
CGAAGCGATGCGTGTA_CGTGTAACCCTCGCAA_CCATGCCAGCGACAGA	P
CCACGCGCGGTACGTC_GGTATGTTAACGGAGA_AGCAACTTGGTTAATG	P
CCACGCGCGGTACGTC_GGTATGTTAACGGAGA_GCTGCAAAGTTGCGAT	P
CCACGCGCGGTACGTC_GGTATGTTAACGGAGA_GACGGCTCTAAGACAT	P
CCACGCGCGGTACGTC_GGTATGTTAACGGAGA_CCTGTGAACTGGCCAC	P
CCACGCGCGGTACGTC_GGTATGTTAACGGAGA_CTCGAAGCAAGGGACT	P
GTACCAAAGAGAGCAG_CGGGAGCGCTTGGGTT_TGAGCGTTGGAGTGGT	P
GTACCAAAGAGAGCAG_CGGGAGCGCTTGGGTT_ACAGATAACGCTACGT	P
GTACCAAAGAGAGCAG_CGGGAGCGCTTGGGTT_CGTCGGAATATTCAAT	P
GTACCAAAGAGAGCAG_CGGGAGCGCTTGGGTT_CTGATATGTCGCGTGC	P;R(A)
GTACCAAAGAGAGCAG_CGGGAGCGCTTGGGTT_GCATAATACGATTTTC	P
GTACCAAAGAGAGCAG_CGGGAGCGCTTGGGTT_CCCCACTTCATTTAAG	P
GTACCAAAGAGAGCAG_CGGGAGCGCTTGGGTT_ACTGCTTGCCTGAATT	P
GTACCAAAGAGAGCAG_CGGGAGCGCTTGGGTT_ATTGCTCGTGCAGAAG	P
GTACCAAAGAGAGCAG_CGGGAGCGCTTGGGTT_CATGCAACAGCGTCAT	P
GTACCAAAGAGAGCAG_CGGGAGCGCTTGGGTT_GGTCTTCCAACACCAT	P
GTACCAAAGAGAGCAG_CGGGAGCGCTTGGGTT_TGGGAACCACTTCTCA	P;R(A)
GTACCAAAGAGAGCAG_CGGGAGCGCTTGGGTT_TTCACCCGAGGCTTGT	P
GTACCAAAGAGAGCAG_CGGGAGCGCTTGGGTT_AGACCTGAGTAGGTGT	P
GTACCAAAGAGAGCAG_CGGGAGCGCTTGGGTT_GTACAACTTCCCGAGT	P
GTACCAAAGAGAGCAG_CGGGAGCGCTTGGGTT_TTCTTGAAAGAGGAGA	P
GTACCAAAGAGAGCAG_CGGGAGCGCTTGGGTT_TACGCCTATGAAAAAT	P
GTACCAAAGAGAGCAG_CGGGAGCGCTTGGGTT_GAACGACCATCCCACC	P
GTACCAAAGAGAGCAG_CGGGAGCGCTTGGGTT_AGTTCATAGAAAGTAT	P
GTACCAAAGAGAGCAG_CGGGAGCGCTTGGGTT_AACCATGGCTACATAT	P
GTACCAAAGAGAGCAG_CGGGAGCGCTTGGGTT_CTTGAGGTGAAATCTC	P
TCAGGCCACGTAAGAG_CTGCGAATACGGTGTG_CGGACCCACACGAGAA	P
TCAGGCCACGTAAGAG_CTGCGAATACGGTGTG_TTCCGGTGATCGGGGA	P
TTATAAACACCCTTCC_CCTGGCGTGTCGAATC_GCAAACCACGATACAT	A
GCAACCCTGCAACTTC_TCTGGACAACGAGCGC_GACGGTCTATTCTCGA	P
TTGACAACTCCGCCGT_GAAGCCTAATACATAA_CTCGATTTGGTGAGAT	P
CGCGGTGGAACGGAGG_CGCAACATGTAAACTT_TACCAGCAGCAATATA	P
CGCGGTGGAACGGAGG_CGCAACATGTAAACTT_TTGATCAGCAGCAGCT	P
CGCGGTGGAACGGAGG_CGCAACATGTAAACTT_GAGAAACTCCAATTAC	P
CGCGGTGGAACGGAGG_CGCAACATGTAAACTT_CCTCTAAACTTTGGGT	P
CGCGGTGGAACGGAGG_CGCAACATGTAAACTT_AGATGTGCACGGACAC	P
CGCGGTGGAACGGAGG_CGCAACATGTAAACTT_AGTAAGAAATCCTATC	P
CGCGGTGGAACGGAGG_CGCAACATGTAAACTT_CAAACAGCTGATCCTG	P
CGCGGTGGAACGGAGG_CGCAACATGTAAACTT_GTGTGTGTTGTTGTGG	P
CGCGGTGGAACGGAGG_CGCAACATGTAAACTT_AACGGCGGTGCTAGCC	P
CGCGGTGGAACGGAGG_CGCAACATGTAAACTT_GCATGTACTCACTCTA	P
CGCGGTGGAACGGAGG_CGCAACATGTAAACTT_ACCAGCTATTCTCGCT	P
CGCGGTGGAACGGAGG_CGCAACATGTAAACTT_CTAGGTCCTATGGCCA	P
CGCGGTGGAACGGAGG_CGCAACATGTAAACTT_CTACGCGCTAGAAGCT	P
CGCGGTGGAACGGAGG_CGCAACATGTAAACTT_TATTGCCAGGGGAAGG	P
CGCGGTGGAACGGAGG_CGCAACATGTAAACTT_CAATCGTCAGAAGTGC	P
CGCGGTGGAACGGAGG_CGCAACATGTAAACTT_CCGTGTTAGACAAAAC	P
CGCGGTGGAACGGAGG_CGCAACATGTAAACTT_AAGATTCGCCGGTGTC	P
CGCGGTGGAACGGAGG_CGCAACATGTAAACTT_CTCGCTGTCAGTTACC	P
CGCGGTGGAACGGAGG_CGCAACATGTAAACTT_TGGAAATGAATCGAGA	P
AGTAAGACCTCGGGCC_CGCGCTTGGTTGGCTC_TTGCGAACACGTAGCC	P
TCCATTGAGAACAACT_TGCACACCCATGAGTA_ACACAAAGCATCTGTT	C
TCCATTGAGAACAACT_TGCACACCCATGAGTA_TGGTCGAAGGACTTGT	P
TCCATTGAGAACAACT_TGCACACCCATGAGTA_ATTGTATCGGCAGCTT	P
TCCATTGAGAACAACT_TGCACACCCATGAGTA_GGGTCCACGAGAGACC	P
TCCATTGAGAACAACT_TGCACACCCATGAGTA_CTCGCAGTGCAAATTT	P
TCCATTGAGAACAACT_TGCACACCCATGAGTA_CGGTCCCAGTTGTATG	C
TCCATTGAGAACAACT_TGCACACCCATGAGTA_AATCAAGATGGCATAT	P
TCCATTGAGAACAACT_TGCACACCCATGAGTA_GAGTCGAAGCTGCGAT	P
TCCATTGAGAACAACT_TGCACACCCATGAGTA_TTTAGACAAATGAGTC	P
GTTTGGCAAGACAGCA_TGGAGAGGGACTGAGT_TTGCAACCAACTATTC	P
GCAACCCTGCAACTTC_TCGGCGATGGTCGAAG_GTACTTGCGATTCATC	P
GCAACCCTGCAACTTC_TCGGCGATGGTCGAAG_GTGGAAGTCGAATTAT	P
AGTAAGACCTCGGGCC_TCCCTGAAGGCACATC_GACAGTACTGAGTATT	P
GTGCGGACCCCGTGAT_ATCCAAAATCTGTGAC_CCGGGAATAGACTCGC	P
GTGCGGACCCCGTGAT_ATCCAAAATCTGTGAC_CAACGCAGACAGATTT	P
ACAATCCGAATGAAGG_CTTGGAACTGCGTTGA_GTCGACAGAACAACAG	P
ACAATCCGAATGAAGG_CTTGGAACTGCGTTGA_CAGGATGGGGATGCTC	P
ACAATCCGAATGAAGG_CTTGGAACTGCGTTGA_ATAATGTCGTGCACTT	P
AACCGATGTTGCCCAA_TTCTCGAAGCACGTAG_GCTTGTCAACAAGATA	P
AACCGATGTTGCCCAA_TTCTCGAAGCACGTAG_GCACGATCCCTGTTGT	P
AACGAGGCAGCGTTTT_CTCCTGGACACGTCTG_GAAGCTGCTTCGATAT	P
AACGAGGCAGCGTTTT_CTCCTGGACACGTCTG_ACAATACCTTTACGCA	P
AACGAGGCAGCGTTTT_CTCCTGGACACGTCTG_AGAGACACCACTGCAA	P
AACGAGGCAGCGTTTT_CTCCTGGACACGTCTG_GGGCACAAACTATCAG	P
AACGAGGCAGCGTTTT_CTCCTGGACACGTCTG_CACCGTCTTGATTGGT	P
AACGAGGCAGCGTTTT_CTCCTGGACACGTCTG_GTAAGACACTATGTGG	P
AACGAGGCAGCGTTTT_CTCCTGGACACGTCTG_ATTCTCGGATGAAGCC	P
ACCCAACAGGTTCAAT_ACCAGAGGAGCGTATT_ATGCCTTGAAGACTCG	P
CCTTGACCTCCGACTA_AAATCTTCCTACGCAA_CAAGCCACGGTTAGGT	P
CCTTGACCTCCGACTA_AAATCTTCCTACGCAA_GTATTCATCACAGCAG	P
TTGCAGGGCAAGGCGC_ACGGACACCACTATAT_TTAGCTAACGAGTACC	C
TCCATTGAGAACAACT_ACCGTCTAAAGCGTGC_ACTGAAGTATCTGGGC	P
TCCATTGAGAACAACT_ACCGTCTAAAGCGTGC_GATGTTCGCGTGTTCA	P
TAGTGGCCTCCCAGAA_CCTCTATCAATAGTTA_TAATATCGGCGTGGGT	P
